8 68
105
0 0 0 1 2 0 0 0 
0 0 3 4 5 6 0 0 
0 7 8 9 10 11 12 0 
0 13 14 15 16 17 18 0 
19 20 21 22 23 24 25 26 
27 27 28 29 30 31 27 27 
32 32 33 34 34 35 32 32 
36 36 36 36 36 36 36 36 
37 37 37 37 37 37 37 37 
38 38 38 38 39 39 39 39 
38 39 39 38 38 38 38 38 
38 38 38 38 38 39 39 39 
37 37 37 37 38 38 38 38 
38 38 38 37 37 37 38 38 
37 37 37 38 39 39 39 39 
39 39 39 39 39 39 39 40 
36 36 41 42 43 44 44 44 
41 42 45 0 46 47 44 44 
45 0 0 0 0 0 46 43 
48 48 48 48 48 48 48 49 
50 50 51 52 53 53 53 53 
54 55 56 57 58 53 53 53 
54 54 59 60 61 50 50 50 
62 63 64 53 53 65 66 62 
67 68 66 66 66 69 66 66 
70 71 72 73 63 53 65 62 
74 75 72 73 76 57 57 77 
53 78 62 62 62 62 67 79 
53 74 75 62 66 66 80 53 
66 69 66 66 66 67 79 53 
81 52 65 82 81 50 50 52 
54 52 53 83 84 50 59 52 
59 52 53 53 85 55 86 53 
87 53 53 53 74 88 79 53 
57 57 57 58 53 53 53 53 
89 55 55 76 90 57 57 57 
85 54 59 88 61 89 54 59 
71 55 86 53 53 83 84 50 
62 72 76 58 53 53 64 64 
72 72 67 61 66 66 66 52 
75 67 70 74 75 66 66 66 
91 70 53 53 91 75 66 66 
66 66 92 93 93 94 66 66 
72 73 52 53 53 74 75 62 
62 73 76 57 58 53 91 75 
81 81 81 95 76 57 57 96 
89 55 55 59 88 88 88 88 
83 89 55 56 57 57 57 57 
57 97 55 55 59 89 59 89 
54 59 60 88 87 83 87 83 
50 50 98 99 99 99 99 99 
55 55 100 101 101 101 101 101 
54 54 54 54 54 55 55 55 
66 66 66 66 102 62 62 62 
75 66 66 62 62 67 75 67 
78 66 102 62 66 66 66 66 
71 72 62 62 62 102 72 73 
62 72 72 72 72 72 102 67 
72 72 72 72 62 62 62 80 
75 102 72 72 72 62 67 79 
103 104 81 81 81 81 50 51 
54 55 55 54 50 51 84 50 
55 55 55 55 54 56 97 55 
89 54 54 55 55 55 55 54 
85 54 54 54 55 55 55 59 
68 89 54 54 54 55 55 56 
57 97 55 55 55 55 55 55 
54 54 54 54 54 54 54 54 
