319
15
0 0 0 0 0 0 0 0 0 0 0 0 0 0 0 0 0 0 0 0 0 0 0 0 0 0 0 0 0 0 0 0 0 0 0 0 0 0 0 0 0 0 0 0 0 0 0 0 0 0 0 0 0 0 0 0 0 0 0 0 0 0 0 0 0 0 0 0 0 0 0 0 0 0 0 0 0 0 0 0 0 0 0 0 0 0 0 0 0 0 0 0 0 0 0 0 0 0 0 0 0 0 0 0 0 0 0 0 0 0 0 0 0 0 0 0 0 0 0 0 0 0 0 0 0 0 0 0 0 0 0 0 0 0 0 0 0 0 0 0 0 0 0 0 0 0 0 0 0 0 0 0 0 0 0 0 0 0 0 0 0 0 0 0 0 0 0 0 0 0 0 0 0 0 0 0 0 0 0 0 0 0 0 0 0 0 0 0 0 0 0 0 0 0 0 0 0 0 0 0 0 0 0 0 0 0 0 0 0 0 0 0 0 0 0 0 0 0 0 0 0 0 0 0 0 0 0 0 0 0 0 0 0 0 0 0 0 0 0 0 0 0 0 0 0 0 0 0 0 0 0 0 0 0 0 0 0 0 0 0 0 0 0 0 0 0 0 0 0 0 0 0 0 0 0 0 0 0 0 0 0 0 0 0 0 0 0 0 0 0 0 0 0 0 0 0 0 0 0 0 0 0 0 0 0 0 0 0 0 0 0 0 0 0 0 0 0 0 0
0 0 0 0 1 2 0 0 3 4 1 2 0 0 0 0 0 0 1 2 3 4 1 2 0 0 3 4 0 0 0 0 0 0 0 0 3 4 0 0 0 0 1 2 3 4 0 0 0 0 3 4 1 2 1 2 0 0 3 4 1 2 0 0 0 0 3 4 1 2 3 4 1 2 0 0 0 5 6 0 1 2 0 0 3 4 0 5 6 5 6 0 0 0 0 0 0 0 3 4 1 2 0 0 0 0 1 2 3 4 0 0 0 0 0 0 3 4 1 2 0 0 3 4 0 0 1 2 0 0 0 0 0 0 0 0 0 0 1 2 0 0 0 0 0 0 0 0 0 0 0 0 0 0 0 0 0 0 0 0 0 0 0 0 0 0 0 0 0 0 0 0 0 0 0 0 0 0 0 0 0 0 0 0 0 0 0 0 0 0 1 2 0 0 3 4 0 0 0 0 0 0 0 0 0 0 0 0 0 0 0 0 0 0 0 0 0 0 0 0 0 0 0 0 0 0 0 0 0 0 0 0 0 0 0 0 0 0 0 1 2 0 0 1 2 3 4 0 0 3 4 1 2 0 0 0 0 0 0 0 0 3 4 1 2 0 0 1 2 0 0 0 0 3 4 1 2 0 0 0 0 0 0 0 0 1 2 0 0 0 0 0 0 0 0 0 0 0 0 0 0 0 0 0 0 0 0 0 0 0 0 0 0 0 0 0 0 0 0
0 0 0 0 4 3 0 0 0 0 4 3 0 0 0 0 0 0 4 3 0 0 4 3 0 0 0 0 0 0 0 0 0 0 0 0 0 0 0 0 0 0 4 3 0 0 0 0 0 0 0 0 4 3 4 3 0 0 0 0 4 3 0 0 0 0 0 0 4 3 0 0 4 3 0 0 7 8 9 10 4 3 0 0 0 0 7 8 9 8 9 10 0 0 0 0 0 0 0 0 4 3 0 0 0 0 4 3 0 0 0 0 0 0 0 0 0 0 4 3 0 0 0 0 0 0 4 3 0 0 0 0 0 0 0 0 0 0 4 3 0 0 0 0 0 0 0 0 0 0 0 0 0 0 0 0 0 0 0 0 0 0 0 0 0 0 0 0 0 0 0 0 0 0 0 0 0 0 0 0 0 0 0 0 0 0 0 0 0 0 4 3 0 0 0 0 0 0 0 0 0 0 0 0 0 0 0 0 0 0 0 0 0 0 0 0 0 0 0 0 0 0 0 0 0 0 0 0 0 0 0 0 0 0 0 0 0 0 0 4 3 0 0 4 3 0 0 0 0 0 0 4 3 0 0 0 0 0 0 0 0 0 0 4 3 0 0 4 3 0 0 0 0 0 0 4 3 0 0 0 0 0 0 0 0 4 3 0 0 0 0 0 0 0 0 0 0 0 0 0 0 0 0 0 0 0 0 0 0 0 0 0 0 0 0 0 0 0 0
0 0 1 2 0 0 1 2 1 2 1 2 3 4 0 0 0 5 6 5 6 5 6 5 6 5 6 5 6 5 6 0 0 0 0 0 0 0 1 2 3 4 3 4 1 2 0 0 0 0 0 0 1 2 1 2 1 2 0 0 0 0 0 0 0 0 1 2 0 0 3 4 0 0 0 0 11 12 13 14 3 4 1 2 0 0 11 12 13 12 13 14 0 0 0 0 0 0 1 2 0 0 0 0 3 4 3 4 1 2 0 0 0 0 3 4 1 2 1 2 0 0 1 2 3 4 1 2 0 0 1 2 0 0 0 0 1 2 0 0 0 0 0 0 0 0 0 0 0 0 0 0 0 0 0 0 0 0 0 0 0 0 0 0 0 0 0 0 0 0 0 0 0 0 0 0 0 0 0 0 0 0 0 0 0 0 3 4 0 0 1 2 0 0 1 2 0 0 0 0 0 0 0 0 0 0 0 0 0 0 0 0 0 0 0 0 0 0 0 0 0 0 0 0 0 0 0 0 0 0 0 0 0 0 0 0 0 0 0 0 0 3 4 0 5 6 5 6 5 6 5 6 0 1 2 3 4 0 0 3 4 1 2 0 0 0 0 0 0 0 0 0 0 0 0 0 0 3 4 0 0 3 4 0 0 0 0 0 0 0 0 0 0 0 0 0 0 0 0 0 0 0 0 0 0 0 0 0 0 0 0 0 0 0 0 0 0 0 0
0 0 4 3 0 0 4 3 4 3 4 3 0 0 0 0 7 8 9 8 9 8 9 8 9 8 9 8 9 8 9 10 0 0 0 0 0 0 4 3 0 0 0 0 4 3 0 0 0 0 0 0 4 3 4 3 4 3 0 0 0 0 0 0 0 0 4 3 0 0 0 0 0 0 0 0 11 12 13 14 0 0 4 3 0 0 11 12 13 12 13 14 0 0 0 0 0 0 4 3 0 0 0 0 0 0 0 0 4 3 0 0 0 0 0 0 4 3 4 3 0 0 4 3 0 0 4 3 0 0 4 3 0 0 0 0 4 3 0 0 0 0 0 0 0 0 0 0 0 0 0 0 0 0 0 0 0 0 0 0 0 0 0 0 0 0 0 0 0 0 0 0 0 0 0 0 0 0 0 0 0 0 0 0 0 0 0 0 0 0 4 3 0 0 4 3 0 0 0 0 0 0 0 0 0 0 0 0 0 0 0 0 0 0 0 0 0 0 0 0 0 0 0 0 0 0 0 0 0 0 0 0 0 0 0 0 0 0 0 0 0 0 0 7 8 9 8 9 8 9 8 9 10 4 3 0 0 0 0 0 0 4 3 0 0 0 0 0 0 0 0 0 0 0 0 0 0 0 0 0 0 0 0 0 0 0 0 0 0 0 0 0 0 0 0 0 0 0 0 0 0 0 0 0 0 0 0 0 0 0 0 0 0 0 0 0 0 0 0
0 0 1 2 3 4 3 4 3 4 1 2 0 0 0 0 11 12 13 12 13 12 13 12 13 12 13 12 13 12 13 14 0 0 1 2 3 4 0 0 0 0 0 0 1 2 0 0 0 0 3 4 0 0 3 4 0 0 0 0 0 0 0 0 0 0 0 0 0 0 0 0 0 0 0 0 15 16 17 0 0 0 0 0 0 0 15 16 15 16 17 0 0 0 0 0 0 0 0 0 0 0 0 0 0 0 0 0 0 0 0 0 0 0 1 2 0 0 0 0 0 0 0 0 0 0 0 0 0 0 0 0 0 0 0 0 1 2 0 0 0 0 0 0 0 0 0 0 0 0 0 0 0 0 0 0 0 0 0 0 0 0 0 0 0 0 0 0 0 0 0 0 0 0 0 0 0 0 0 0 0 0 0 0 3 4 1 2 0 0 3 4 0 0 0 0 0 0 0 0 0 0 0 0 0 0 0 0 0 0 0 0 0 0 0 0 0 0 0 0 0 0 0 0 0 0 0 0 0 0 0 0 0 0 0 0 0 0 0 0 0 1 2 11 12 13 12 13 12 13 12 13 14 0 0 0 0 0 0 0 0 0 0 0 0 3 4 0 0 0 0 0 0 0 0 3 4 0 0 1 2 1 2 0 0 0 0 0 0 0 0 0 0 0 0 0 0 0 0 0 0 0 0 0 0 0 0 0 0 0 0 0 0 0 0 0 0 0 0
0 0 4 3 0 0 0 0 0 0 4 3 0 0 0 0 11 12 13 12 13 12 13 12 13 12 13 12 13 12 13 14 0 0 4 3 0 0 0 0 0 0 0 0 4 3 0 0 0 0 0 0 0 0 0 0 0 0 0 0 18 19 20 21 20 21 20 22 0 0 0 0 0 23 20 21 24 19 24 19 20 22 0 0 18 19 24 19 24 19 24 19 20 22 0 0 0 0 18 19 20 21 20 21 20 22 0 0 0 0 0 0 0 0 4 3 0 0 0 0 0 0 0 0 0 0 0 0 0 0 0 0 0 0 0 0 4 3 0 0 0 0 0 0 0 0 0 0 0 0 0 0 0 0 0 0 0 0 0 0 0 0 0 0 0 0 0 0 0 0 0 0 0 0 0 0 0 0 0 0 0 0 0 0 0 0 4 3 0 0 0 0 0 0 0 0 0 0 0 0 0 0 0 0 0 0 0 0 0 0 0 0 0 0 0 0 0 0 0 0 0 0 0 0 0 0 0 0 0 0 0 0 0 0 0 0 0 0 0 0 0 4 3 11 12 13 12 13 12 13 12 13 14 0 0 0 0 0 0 0 0 0 0 0 0 0 0 0 0 0 0 0 0 0 0 0 0 0 0 4 3 4 3 0 0 0 0 0 0 0 0 0 0 0 0 0 0 0 0 0 0 0 0 0 0 0 0 0 0 0 0 0 0 25 26 27 28 29 0
0 0 0 0 0 0 1 2 0 0 0 0 1 2 0 0 15 16 15 16 15 16 15 16 15 16 15 16 15 16 15 30 0 0 0 0 18 19 20 21 20 21 22 0 0 0 0 0 0 0 0 0 0 0 0 0 0 0 0 0 31 32 31 32 31 32 31 33 0 0 0 0 0 34 31 32 31 32 31 32 31 33 0 0 31 32 31 32 31 32 31 32 31 33 0 0 0 0 35 36 37 36 31 32 31 38 0 0 0 0 23 21 39 22 0 0 0 0 0 0 0 0 0 0 0 0 23 21 39 22 0 0 0 0 0 0 0 0 0 0 0 0 0 0 0 0 0 0 0 0 0 0 0 0 0 0 0 0 0 0 0 0 0 0 0 0 0 0 0 0 0 0 0 0 0 0 0 0 0 0 0 0 0 0 0 0 0 0 0 0 0 0 0 0 0 0 0 0 0 0 0 0 0 0 0 0 0 0 0 0 0 0 0 0 0 0 0 0 0 0 0 0 0 0 0 0 0 0 0 0 0 0 0 0 0 0 0 0 0 3 4 0 0 15 16 15 16 15 16 15 16 15 30 0 0 18 19 20 21 24 19 20 21 24 19 20 21 20 22 0 0 0 0 0 0 0 0 0 0 0 0 0 0 0 0 0 0 0 0 0 0 0 0 0 0 0 0 0 0 0 0 0 0 0 0 0 0 0 0 0 0 0 0 40 41 42 43 44 45
0 0 0 0 0 0 4 3 0 0 0 0 4 3 0 0 46 47 46 47 46 47 46 47 46 47 46 47 46 47 46 30 0 0 0 0 48 32 31 32 31 32 38 0 0 0 0 0 0 0 0 0 0 0 0 0 0 0 0 0 49 50 51 50 51 50 51 52 0 0 0 0 0 53 51 50 37 36 37 36 51 52 0 0 49 50 51 50 51 50 51 50 51 52 0 0 0 0 54 55 56 55 37 36 37 33 18 19 20 22 57 58 59 60 0 0 0 0 0 0 0 0 0 0 0 0 57 58 59 60 0 0 0 0 0 0 0 0 0 0 0 0 0 0 0 0 0 0 0 0 0 0 0 0 0 0 0 0 0 0 0 0 0 0 0 0 0 0 0 0 0 0 0 0 0 0 0 0 0 0 0 0 0 0 0 0 18 19 20 21 20 22 0 0 0 0 0 0 0 0 0 0 0 0 0 0 0 0 0 0 0 0 0 0 0 0 0 0 0 0 0 0 0 0 0 0 0 0 0 0 0 0 0 0 0 0 0 0 0 0 0 0 0 46 47 46 47 46 47 46 47 46 30 0 0 48 32 31 32 31 32 31 32 31 32 31 32 31 38 0 0 0 0 0 0 0 0 0 0 0 0 0 0 0 0 0 0 0 0 0 0 0 0 0 0 0 0 0 0 0 0 0 0 0 0 0 0 0 0 0 0 0 0 61 62 63 64 65 66
20 21 24 19 20 21 24 19 20 21 24 19 20 21 24 19 20 21 24 19 20 21 24 19 20 21 24 19 20 21 24 19 20 21 39 22 35 36 37 36 37 36 33 0 0 0 23 21 20 21 20 21 20 22 0 0 0 0 18 19 20 21 20 21 24 19 20 21 24 19 20 21 24 19 39 22 35 67 37 33 23 21 24 19 20 21 24 19 20 21 24 19 39 22 0 0 0 0 35 67 37 36 37 36 31 33 31 32 31 68 35 36 37 33 0 0 23 21 39 22 0 0 23 22 0 0 35 36 37 33 0 0 23 21 24 19 20 21 24 19 39 22 0 0 0 0 0 0 0 0 0 0 0 0 0 0 0 0 0 0 0 0 0 0 0 0 0 0 0 0 0 0 0 0 0 0 0 0 0 0 0 0 0 0 0 0 31 32 31 32 31 68 0 0 23 21 39 22 0 0 0 0 0 0 0 0 0 0 0 0 0 0 0 0 0 0 0 0 0 0 0 0 0 0 0 0 0 0 0 0 0 0 0 0 0 0 0 0 0 0 0 18 19 24 19 20 21 24 19 20 21 20 22 0 0 35 36 37 36 37 36 37 36 37 36 37 36 37 33 23 21 24 19 20 21 24 19 20 21 24 19 20 21 39 22 0 0 0 0 0 0 0 0 0 0 0 0 0 0 0 0 0 0 0 0 0 0 0 0 0 0 0 0 69 70 71 72 73 74
31 32 31 32 31 32 31 32 31 32 31 32 31 32 31 32 31 32 31 32 31 32 31 32 31 32 31 32 31 32 31 32 31 32 59 60 54 55 56 55 56 55 75 0 0 0 57 58 31 32 31 32 31 38 0 0 0 0 48 32 31 32 31 32 31 32 31 32 31 32 31 32 31 32 59 60 76 77 78 52 57 58 31 32 31 32 31 32 31 32 31 32 59 60 0 0 0 0 76 77 78 79 78 79 51 52 49 50 51 80 54 55 56 81 0 0 57 58 59 60 0 0 31 32 0 0 54 55 56 81 0 0 57 58 31 32 31 32 31 32 59 60 0 0 0 0 0 0 0 0 0 0 0 0 0 0 0 0 0 0 0 0 0 0 0 0 0 0 0 0 0 0 0 0 0 0 0 0 0 0 0 0 0 0 0 0 49 50 51 50 51 80 0 0 57 58 59 60 0 0 0 0 0 0 0 0 0 0 0 0 0 0 0 0 0 0 0 0 0 0 0 0 0 0 0 0 0 0 0 0 0 0 0 0 0 0 0 0 0 0 0 48 32 31 32 31 32 31 32 31 32 31 38 0 0 54 55 56 55 56 55 56 55 56 55 56 55 56 81 57 58 31 32 31 32 31 32 31 32 31 32 31 32 59 60 0 0 0 0 0 0 0 0 0 0 0 0 0 0 0 0 0 0 0 0 0 0 0 0 0 0 0 0 69 70 71 82 83 84
37 36 37 36 37 36 37 36 37 36 37 36 37 36 37 36 37 36 37 36 37 36 37 36 37 36 37 36 37 36 37 36 37 36 85 33 49 50 86 87 86 87 88 0 0 0 35 36 37 36 37 33 51 89 0 0 0 0 49 50 35 67 37 36 37 36 37 36 37 36 37 36 37 36 37 33 0 0 0 0 35 67 37 36 37 36 37 36 85 33 35 36 37 33 0 0 0 0 23 21 24 19 20 21 24 19 20 21 39 22 35 36 37 33 90 90 35 36 37 33 90 90 35 36 90 90 35 36 37 33 90 90 35 36 37 36 37 36 37 36 37 33 91 92 93 93 91 92 93 93 91 92 93 93 91 92 93 93 91 92 93 93 91 92 93 93 91 92 93 93 91 92 93 94 93 93 93 94 93 93 93 93 23 21 24 19 20 21 24 19 20 21 39 22 35 36 37 33 93 93 91 92 93 93 91 92 93 93 91 92 93 93 91 92 93 93 91 92 93 93 91 92 93 93 91 92 93 93 93 95 93 93 93 95 93 93 93 93 93 93 93 49 50 51 50 51 36 37 36 37 36 37 33 0 0 49 50 86 87 86 87 86 87 86 87 86 87 86 87 35 36 37 36 37 36 37 36 37 36 37 36 37 36 37 33 95 93 93 93 95 93 93 93 95 93 93 93 95 93 93 93 93 93 93 93 93 93 93 93 93 93 93 96 97 98 99 100 101 101
78 79 78 79 78 79 78 79 78 79 78 79 78 79 78 79 78 79 78 79 78 79 78 79 78 79 78 79 78 79 78 79 78 79 50 81 39 21 24 19 24 19 20 21 20 22 54 55 78 79 78 52 20 21 20 21 20 21 39 21 76 77 78 79 78 79 78 79 78 79 78 79 78 79 78 52 0 0 0 0 76 77 78 79 78 79 78 79 50 81 54 55 56 81 0 0 0 0 57 58 31 32 31 32 31 32 31 32 59 60 54 55 56 81 102 102 54 55 56 81 102 102 54 55 102 102 54 55 56 81 102 102 54 55 56 55 56 55 56 55 56 81 103 103 103 103 103 103 103 103 103 103 103 103 103 103 103 103 103 103 103 103 103 103 103 103 103 103 103 103 103 103 103 103 103 103 103 103 103 103 103 103 57 58 31 32 31 32 31 32 31 32 59 60 54 55 56 81 103 103 103 103 103 103 103 103 103 103 103 103 103 103 103 103 103 103 103 103 103 103 103 103 103 103 103 103 103 103 103 103 103 103 103 103 103 103 103 103 103 103 103 39 21 20 21 22 104 78 79 78 79 78 52 18 19 39 21 24 19 24 19 24 19 24 19 24 19 20 22 54 55 78 79 78 79 78 79 78 79 78 79 78 79 78 52 103 103 103 103 103 103 103 103 103 103 103 103 103 103 103 103 103 103 103 103 103 103 103 103 103 103 103 103 103 103 103 103 103 103
105 106 105 106 105 106 105 106 105 106 105 106 105 106 105 106 105 106 105 106 105 106 105 106 105 106 105 106 105 106 105 106 105 106 107 108 31 32 31 32 31 32 31 32 31 68 108 109 105 106 110 6 31 32 31 32 31 32 31 68 111 112 105 106 105 106 105 106 105 106 105 106 105 106 105 106 105 106 105 106 105 106 105 106 105 106 105 106 107 108 35 67 85 33 23 21 39 22 35 36 37 36 37 36 37 36 37 36 37 33 35 36 37 33 113 114 115 116 115 116 117 118 115 116 113 114 115 116 115 116 117 118 35 36 119 120 119 120 119 120 37 33 93 93 93 93 93 93 93 93 93 93 93 93 93 93 93 93 93 93 93 93 93 93 93 93 93 93 93 93 93 93 93 93 93 93 93 93 93 93 93 93 35 67 37 36 37 36 37 36 37 36 37 33 35 36 37 33 93 93 93 93 93 93 93 93 93 93 93 93 93 93 93 93 93 93 93 93 93 93 93 93 93 93 93 93 93 93 93 93 93 93 93 93 93 93 93 93 93 93 93 35 36 31 32 33 121 105 106 105 106 110 6 122 123 31 68 31 68 31 68 31 68 31 68 31 68 31 68 108 109 105 106 105 106 105 106 105 106 105 106 105 106 110 6 93 93 93 93 93 93 93 93 93 93 93 93 93 93 93 93 93 93 93 93 93 93 93 93 93 93 93 93 93 93 93 93 93 93
124 125 124 125 124 125 124 125 124 125 124 125 124 125 124 125 124 125 124 125 124 125 124 125 124 125 124 125 124 125 124 125 124 125 126 10 49 50 51 50 51 50 51 50 51 80 7 127 124 125 128 14 49 50 51 50 51 50 51 80 129 127 124 125 124 125 124 125 124 125 124 125 124 125 124 125 124 125 124 125 124 125 124 125 124 125 124 125 126 10 76 77 50 81 57 58 59 60 54 55 56 55 56 55 56 55 56 55 56 81 54 55 56 81 130 131 131 132 131 132 132 133 131 132 130 131 131 132 131 132 132 133 54 55 134 135 134 135 134 135 56 81 103 103 103 103 103 103 103 103 103 103 103 103 103 103 103 103 103 103 103 103 103 103 103 103 103 103 103 103 103 103 103 103 103 103 103 103 103 103 103 103 76 77 78 79 78 79 78 79 78 79 78 52 54 55 56 81 103 103 103 103 103 103 103 103 103 103 103 103 103 103 103 103 103 103 103 103 103 103 103 103 103 103 103 103 103 103 103 103 103 103 103 103 103 103 103 103 103 103 103 54 55 37 36 75 136 124 125 124 125 128 14 49 137 51 80 51 80 51 80 51 80 51 80 51 80 51 80 7 127 124 125 124 125 124 125 124 125 124 125 124 125 128 14 103 103 103 103 103 103 103 103 103 103 103 103 103 103 103 103 103 103 103 103 103 103 103 103 103 103 103 103 103 103 103 103 103 103