208
15
0 0 0 0 0 0 0 0 0 0 0 0 0 0 0 0 0 0 0 0 0 0 0 0 0 0 0 0 0 0 0 0 0 0 0 0 0 0 0 0 0 0 0 0 0 0 0 0 0 0 0 0 0 0 0 0 0 0 0 0 0 0 0 0 0 0 0 0 0 0 0 0 0 0 0 0 0 0 0 0 0 0 0 0 0 0 0 0 0 0 0 0 0 0 0 0 0 0 0 0 0 0 0 0 0 0 0 0 0 0 0 0 0 0 0 0 0 0 0 0 0 0 0 0 0 0 0 0 0 0 0 0 0 0 0 0 0 0 0 0 0 0 0 0 0 0 0 0 0 0 0 0 0 0 0 0 0 0 0 0 0 0 0 0 0 0 0 0 0 0 0 0 0 0 0 0 0 0 0 0 0 0 0 0 0 0 0 0 0 0 0 0 0 0 0 0 0 0 0 0 0 0 0 0 0 0 0 0
0 0 0 0 0 0 0 0 0 0 0 0 0 0 0 0 0 0 0 0 0 0 0 0 0 0 0 0 0 0 0 0 0 0 0 0 0 0 0 0 0 0 0 0 0 0 0 0 0 0 0 0 0 0 0 0 0 0 0 0 0 0 0 0 0 0 0 0 0 0 0 0 0 0 0 0 0 0 0 0 0 0 0 0 0 0 1 2 3 2 3 2 3 2 3 2 3 2 3 2 3 2 3 2 3 2 3 2 3 2 3 2 3 2 3 2 3 2 3 2 3 2 3 2 3 2 3 2 3 2 3 2 3 2 3 2 3 2 3 2 3 2 3 2 3 2 3 2 3 2 3 2 3 2 3 2 3 2 3 2 3 2 3 2 3 2 3 2 3 2 3 2 3 2 3 2 3 2 3 2 3 2 3 2 3 2 3 2 3 2 3 2 3 2 3 2 3 2 4 0 0 0 0 0 0 0 0 0
0 0 0 0 0 0 0 5 6 7 8 5 6 7 8 0 0 0 0 0 0 5 6 7 8 5 6 7 8 5 6 7 8 5 6 7 8 5 6 7 8 0 0 0 0 0 0 0 0 0 0 0 0 0 0 0 0 0 0 0 0 0 0 0 0 0 0 0 0 0 0 0 0 0 0 0 0 0 0 5 6 7 8 0 0 0 9 10 11 10 11 10 11 10 11 10 11 10 11 10 11 10 11 10 11 10 11 10 11 10 11 10 11 10 11 10 11 10 11 10 11 10 11 10 11 10 11 10 11 10 11 10 11 10 11 10 11 10 11 10 11 10 11 10 11 10 11 10 11 10 11 10 11 10 11 10 11 10 11 10 11 10 12 13 12 13 12 13 12 13 12 13 12 13 12 13 12 13 12 13 12 13 12 13 12 13 12 13 12 13 12 13 12 13 12 13 12 13 14 15 0 0 0 0 0 0 0 0
0 0 0 0 0 0 16 17 18 19 20 17 18 19 21 0 0 0 0 0 16 17 18 19 20 17 18 19 20 17 18 19 20 17 18 19 20 17 18 19 21 0 0 0 0 0 0 0 0 0 0 0 0 0 0 0 0 0 0 0 0 0 0 0 0 0 0 0 0 0 0 0 0 0 0 0 0 0 16 17 18 19 21 0 0 0 22 23 22 23 22 23 22 23 22 23 22 23 22 23 22 23 22 23 22 23 22 23 22 23 22 23 22 23 22 23 22 23 22 23 22 23 22 23 22 23 22 23 22 23 22 23 22 23 22 23 22 23 22 23 22 23 22 23 22 23 22 23 22 23 22 23 22 23 22 23 22 23 22 23 22 23 24 2 3 2 3 2 3 2 3 2 3 2 3 2 3 2 3 2 3 2 3 2 3 2 3 2 3 2 3 2 3 2 3 2 3 2 3 2 25 0 0 0 0 0 0 0
0 0 0 0 0 0 26 27 28 29 26 30 28 29 0 0 0 0 0 0 26 27 28 29 26 30 28 29 26 30 28 29 26 30 28 29 26 30 28 29 0 0 0 0 0 0 0 0 0 0 0 0 0 0 0 0 0 0 0 0 0 0 0 0 0 0 0 0 0 0 0 0 0 0 0 0 0 0 26 27 28 29 0 0 0 0 31 32 31 32 31 32 31 32 31 32 31 32 31 32 31 32 31 32 31 32 31 32 31 32 31 32 31 32 31 32 31 32 22 23 22 23 22 23 22 23 22 23 31 32 31 32 31 32 31 32 31 32 22 23 22 23 22 23 22 23 22 23 22 23 22 23 22 23 22 23 31 32 31 32 22 23 33 34 11 10 11 10 11 10 11 10 11 10 11 10 11 10 11 10 11 10 11 10 11 10 11 10 11 10 11 10 11 10 11 10 11 10 11 10 35 0 0 0 0 0 0 0
0 0 36 37 37 38 37 39 36 37 37 39 36 37 36 37 37 38 37 38 37 38 37 39 36 37 37 38 37 38 37 39 37 39 36 37 37 38 37 38 36 37 37 38 37 38 37 39 0 0 0 0 0 0 0 0 36 37 37 38 37 38 37 38 37 39 0 0 0 0 0 0 0 0 36 37 37 38 37 38 37 38 37 38 37 39 40 41 40 41 40 41 40 41 40 41 40 41 40 41 40 41 40 41 40 41 40 41 40 41 40 41 40 41 40 41 40 41 22 23 22 23 22 23 22 23 22 23 40 41 40 41 40 41 40 41 40 41 22 23 22 23 22 23 22 23 22 23 22 23 22 23 22 23 22 23 40 41 40 41 22 23 22 23 22 23 22 23 22 23 22 23 22 23 22 23 22 23 22 23 22 23 22 23 22 23 22 23 22 23 22 23 22 23 22 23 22 23 22 23 22 0 0 0 0 0 0 0
0 0 42 43 44 45 46 47 42 43 46 47 42 43 42 43 44 45 44 45 44 45 46 47 42 43 44 45 44 45 46 47 46 47 42 43 44 45 44 45 42 43 44 45 44 45 46 47 0 0 0 0 0 0 0 0 42 43 44 45 44 45 44 45 46 47 0 0 0 0 0 0 0 0 42 43 44 45 44 45 44 45 44 45 46 47 48 49 48 49 48 49 48 49 48 49 48 49 48 49 48 49 48 49 48 49 48 49 48 49 48 49 48 49 48 49 48 49 31 32 31 32 31 32 31 32 31 32 48 49 48 49 48 49 48 49 48 49 22 23 31 32 31 32 22 23 22 23 22 23 22 23 22 23 31 32 48 49 48 49 22 23 31 32 31 32 22 23 22 23 22 23 22 23 22 23 22 23 22 23 22 23 22 23 22 23 22 23 31 32 31 32 31 32 31 32 22 23 22 23 22 0 0 0 0 0 0 0
0 0 40 41 40 41 40 41 40 41 40 41 40 41 40 41 40 41 40 41 40 41 40 41 40 41 40 41 40 41 40 41 40 41 40 41 40 41 40 41 40 41 40 41 40 41 40 41 0 0 0 0 0 0 0 0 40 41 40 41 40 41 40 41 40 41 0 0 0 0 0 0 0 0 40 41 40 41 40 41 40 41 40 41 40 41 40 41 40 41 50 51 50 51 50 51 50 51 50 51 50 51 50 51 50 51 50 51 50 51 50 51 50 51 50 51 40 41 40 41 40 41 40 41 40 41 40 41 40 41 50 51 50 51 50 51 50 51 22 23 40 41 40 41 22 23 22 23 22 23 22 23 22 23 40 41 40 41 50 51 22 23 40 41 40 41 22 23 22 23 22 23 22 23 22 23 22 23 22 23 22 23 22 23 22 23 22 23 40 41 40 41 40 41 40 41 22 23 22 23 22 0 0 0 0 0 0 0
0 0 48 49 48 49 48 49 48 49 48 49 48 49 48 49 48 49 48 49 48 49 48 49 48 49 48 49 48 49 48 49 48 49 48 49 48 49 48 49 48 49 48 49 48 49 48 49 0 0 0 0 0 0 0 0 48 49 48 49 48 49 48 49 48 49 0 0 0 0 0 0 0 0 48 49 48 49 48 49 48 49 48 49 48 49 48 49 48 49 52 53 52 53 52 53 52 53 52 53 52 53 52 53 52 53 52 53 52 53 52 53 52 53 52 53 48 49 48 49 48 49 48 49 48 49 48 49 48 49 52 53 52 53 52 53 52 53 31 32 48 49 48 49 22 23 31 32 31 32 22 23 22 23 48 49 48 49 52 53 22 23 48 49 48 49 31 32 31 32 31 32 31 32 22 23 22 23 22 23 22 23 22 23 31 32 31 32 48 49 48 49 48 49 48 49 31 32 22 23 22 0 0 0 0 0 0 0
54 54 50 51 50 51 50 51 50 51 40 41 40 41 40 41 50 51 50 51 50 51 50 51 50 51 40 41 40 41 50 51 50 51 50 51 50 51 50 51 50 51 50 51 50 51 50 51 54 54 54 54 54 54 54 54 50 51 50 51 50 51 50 51 50 51 54 54 54 54 54 54 54 54 50 51 50 51 50 51 50 51 50 51 50 51 50 51 50 51 50 51 50 51 50 51 50 51 50 51 40 41 40 41 40 41 40 41 40 41 40 41 40 41 50 51 50 51 50 51 50 51 50 51 50 51 50 51 50 51 50 51 50 51 50 51 40 41 40 41 40 41 50 51 22 23 40 41 40 41 22 23 22 23 50 51 50 51 50 51 22 23 50 51 40 41 40 41 40 41 40 41 40 41 22 23 22 23 22 23 22 23 22 23 40 41 40 41 50 51 50 51 50 51 50 51 40 41 22 23 22 0 0 0 0 0 0 0
54 54 52 53 52 53 52 53 52 53 48 49 48 49 48 49 52 53 52 53 52 53 52 53 52 53 48 49 48 49 52 53 52 53 52 53 52 53 52 53 40 41 40 41 40 41 52 53 54 54 54 54 54 54 54 54 52 53 52 53 52 53 52 53 52 53 54 54 54 54 54 54 54 54 52 53 52 53 52 53 52 53 52 53 52 53 52 53 52 53 52 53 52 53 40 41 40 41 52 53 48 49 48 49 48 49 48 49 48 49 48 49 48 49 52 53 52 53 52 53 52 53 52 53 52 53 52 53 52 53 52 53 40 41 52 53 48 49 48 49 48 49 52 53 22 23 48 49 48 49 31 32 31 32 52 53 52 53 40 41 22 23 52 53 48 49 48 49 48 49 48 49 48 49 22 23 22 23 31 32 31 32 22 23 48 49 48 49 52 53 40 41 40 41 40 41 48 49 31 32 22 0 0 0 0 0 0 0
54 55 50 51 50 51 50 51 50 51 50 51 50 51 50 51 40 41 50 51 50 51 40 41 50 51 50 51 50 51 50 51 50 51 50 51 50 51 50 51 56 57 56 57 56 57 50 51 58 54 54 54 54 54 54 55 50 51 50 51 50 51 50 51 50 51 58 54 54 54 54 54 54 55 50 51 50 51 50 51 50 51 50 51 50 51 50 51 50 51 50 51 50 51 56 57 56 57 50 51 50 51 50 51 50 51 50 51 50 51 50 51 50 51 50 51 50 51 50 51 40 41 40 41 50 51 40 41 40 41 50 51 56 57 50 51 50 51 50 51 50 51 50 51 22 23 50 51 40 41 40 41 40 41 50 51 50 51 56 57 22 23 50 51 50 51 50 51 50 51 50 51 50 51 22 23 22 23 40 41 40 41 22 23 50 51 50 51 50 51 56 57 56 57 50 51 50 51 40 41 22 0 0 0 0 0 0 0
54 59 60 61 60 61 60 61 60 62 52 53 52 53 52 53 48 49 52 53 52 53 48 49 63 62 52 53 52 53 63 61 60 61 60 62 52 53 52 53 52 53 52 53 52 53 63 61 64 54 54 54 54 54 54 59 60 61 60 61 60 61 60 61 60 61 64 54 54 54 54 54 54 59 60 61 60 62 52 53 52 53 52 53 52 53 52 53 52 53 52 53 52 53 52 53 52 53 63 62 52 53 52 53 52 53 52 53 52 53 52 53 52 53 52 53 52 53 52 53 48 49 48 49 52 53 48 49 48 49 52 53 52 53 52 53 52 53 52 53 52 53 52 53 22 23 52 53 48 49 48 49 48 49 52 53 52 53 52 53 22 23 52 53 52 53 52 53 52 53 52 53 52 53 31 32 22 23 48 49 48 49 22 23 52 53 52 53 52 53 52 53 52 53 52 53 52 53 48 49 31 0 0 0 0 0 0 0
54 54 54 54 54 54 54 54 54 59 60 61 60 61 60 61 60 65 40 41 40 41 66 61 64 59 60 61 60 61 64 54 54 54 54 59 60 65 40 41 40 41 66 61 60 61 64 54 54 54 54 54 54 54 54 54 54 54 54 54 54 54 54 54 54 54 54 54 54 54 54 54 54 54 54 54 54 59 60 61 60 61 60 61 60 61 60 65 40 41 40 41 40 41 66 61 60 61 64 59 60 61 60 61 60 61 60 65 40 41 40 41 40 41 40 41 40 41 40 41 50 51 50 51 50 51 50 51 50 51 50 51 50 51 50 51 50 51 50 51 50 51 50 51 22 23 40 41 50 51 50 51 50 51 50 51 40 41 50 51 22 23 50 51 50 51 50 51 50 51 40 41 40 41 40 41 22 23 50 51 50 51 22 23 50 51 50 51 40 41 40 41 40 41 40 41 40 41 40 41 40 67 68 0 0 0 0 0
54 54 54 54 54 54 54 54 54 54 54 54 54 54 54 54 54 59 60 61 60 61 64 54 54 54 54 54 54 54 54 54 54 54 54 54 54 59 60 61 60 61 64 54 54 54 54 54 54 54 54 54 54 54 54 54 54 54 54 54 54 54 54 54 54 54 54 54 54 54 54 54 54 54 54 54 54 54 54 54 54 54 54 54 54 54 54 59 60 61 60 61 60 61 64 54 54 54 54 54 54 54 54 54 54 54 54 59 60 61 69 49 48 49 48 49 48 49 48 49 52 53 52 53 52 53 52 53 52 53 52 53 52 53 52 53 52 53 52 53 52 53 52 53 22 23 48 49 52 53 52 53 52 53 52 53 48 49 52 53 22 23 52 53 52 53 52 53 52 53 48 49 48 49 48 49 22 23 52 53 52 53 22 23 52 53 52 53 48 49 48 49 48 49 48 49 48 49 48 49 48 49 48 0 0 0 0 0