208
15
0 0 0 0 0 0 0 0 0 0 0 0 0 0 0 0 0 0 0 0 0 0 0 0 0 0 0 0 0 0 0 0 0 0 0 0 0 0 0 0 0 0 0 0 0 0 0 0 0 0 0 0 0 0 0 0 0 0 0 0 0 0 0 0 0 0 0 0 0 0 0 0 0 0 0 0 0 0 0 0 0 0 0 0 0 0 0 0 0 0 0 0 0 0 0 0 0 0 0 0 0 0 0 0 0 0 0 0 0 0 0 0 0 0 0 0 0 0 0 0 0 0 0 0 0 0 0 0 0 0 0 0 0 0 0 0 0 0 0 0 0 0 0 0 0 0 0 0 0 0 0 0 0 0 0 0 0 0 0 0 0 0 0 0 0 0 0 0 0 0 0 0 0 0 0 0 0 0 0 0 0 0 0 0 0 0 0 0 0 0 0 0 0 0 0 0 0 0 0 0 0 0 0 0 0 0 0 0
1 1 1 2 1 1 2 3 4 0 5 3 4 0 0 3 1 1 1 2 2 3 4 0 5 3 4 0 5 3 4 0 5 3 4 0 5 3 4 0 0 3 0 0 1 1 0 0 1 1 1 2 0 0 1 1 1 2 1 2 0 0 1 1 0 0 0 0 0 0 1 2 1 1 0 0 1 2 2 3 4 0 0 3 1 2 6 7 8 7 8 7 8 7 8 7 8 7 8 7 8 7 8 7 8 7 8 7 8 7 8 7 8 7 8 7 8 7 8 7 8 7 8 7 8 7 8 7 8 7 8 7 8 7 8 7 8 7 8 7 8 7 8 7 8 7 8 7 8 7 8 7 8 7 8 7 8 7 8 7 8 7 8 7 8 7 8 7 8 7 8 7 8 7 8 7 8 7 8 7 8 7 8 7 8 7 8 7 8 7 8 7 8 7 8 7 8 7 9 0 0 0 0 0 0 0 0 0
5 4 5 1 5 4 5 10 11 12 13 10 11 12 13 1 5 4 5 1 5 10 11 12 13 10 11 12 13 10 11 12 13 10 11 12 13 10 11 12 13 1 0 0 5 4 0 0 5 4 5 1 0 0 5 4 5 1 5 1 0 0 5 4 0 0 0 0 0 0 5 1 5 4 0 0 5 1 5 10 11 12 13 1 5 1 14 15 16 15 16 15 16 15 16 15 16 15 16 15 16 15 16 15 16 15 16 15 16 15 16 15 16 15 16 15 16 15 16 15 16 15 16 15 16 15 16 15 16 15 16 15 16 15 16 15 16 15 16 15 16 15 16 15 16 15 16 15 16 15 16 15 16 15 16 15 16 15 16 15 16 15 17 18 17 18 17 18 17 18 17 18 17 18 17 18 17 18 17 18 17 18 17 18 17 18 17 18 17 18 17 18 17 18 17 18 17 18 19 20 0 0 0 0 0 0 0 0
1 2 0 0 0 0 21 22 23 24 25 22 23 24 26 0 0 0 0 0 21 22 23 24 25 22 23 24 25 22 23 24 25 22 23 24 25 22 23 24 26 0 1 1 1 2 0 0 0 0 0 0 1 1 1 2 1 1 1 1 0 0 0 0 1 2 1 2 0 0 1 1 0 0 0 0 0 0 21 22 23 24 26 0 1 1 27 28 27 28 27 28 27 28 27 28 27 28 27 28 27 28 27 28 27 28 27 28 27 28 27 28 27 28 27 28 27 28 27 28 27 28 27 28 27 28 27 28 27 28 27 28 27 28 27 28 27 28 27 28 27 28 27 28 27 28 27 28 27 28 27 28 27 28 27 28 27 28 27 28 27 28 29 7 8 7 8 7 8 7 8 7 8 7 8 7 8 7 8 7 8 7 8 7 8 7 8 7 8 7 8 7 8 7 8 7 8 7 8 7 30 0 0 0 0 0 0 0
5 1 0 0 0 0 31 32 33 34 31 35 33 34 0 0 0 0 0 0 31 32 33 34 31 35 33 34 31 35 33 34 31 35 33 34 31 35 33 34 0 0 5 4 5 1 0 0 0 0 0 0 5 4 5 1 5 4 5 4 0 0 0 0 5 1 5 1 0 0 5 4 0 0 0 0 0 0 31 32 33 34 0 0 5 4 36 37 36 37 36 37 36 37 36 37 36 37 36 37 36 37 36 37 36 37 36 37 36 37 36 37 36 37 36 37 36 37 27 28 27 28 27 28 27 28 27 28 36 37 36 37 36 37 36 37 36 37 27 28 27 28 27 28 27 28 27 28 27 28 27 28 27 28 27 28 36 37 36 37 27 28 38 39 16 15 16 15 16 15 16 15 16 15 16 15 16 15 16 15 16 15 16 15 16 15 16 15 16 15 16 15 16 15 16 15 16 15 16 15 40 0 0 0 0 0 0 0
0 0 41 42 42 43 42 44 41 42 42 44 41 42 41 42 42 43 42 43 42 43 42 44 41 42 42 43 42 43 42 44 42 44 41 42 42 43 42 43 41 42 42 43 42 43 42 44 0 0 1 2 0 0 0 0 41 42 42 43 42 43 42 43 42 44 0 0 0 0 0 0 0 0 41 42 42 43 42 43 42 43 42 43 42 44 45 46 45 46 45 46 45 46 45 46 45 46 45 46 45 46 45 46 45 46 45 46 45 46 45 46 45 46 45 46 45 46 27 28 27 28 27 28 27 28 27 28 45 46 45 46 45 46 45 46 45 46 27 28 27 28 27 28 27 28 27 28 27 28 27 28 27 28 27 28 45 46 45 46 27 28 27 28 27 28 27 28 27 28 27 28 27 28 27 28 27 28 27 28 27 28 27 28 27 28 27 28 27 28 27 28 27 28 27 28 27 28 27 28 27 0 0 0 0 0 0 0
0 0 47 48 49 50 51 52 47 48 51 52 47 48 47 48 49 50 49 50 49 50 51 52 47 48 49 50 49 50 51 52 51 52 47 48 49 50 49 50 47 48 49 50 49 50 51 52 0 0 5 1 0 0 0 0 47 48 49 50 49 50 49 50 51 52 0 0 0 0 0 0 0 0 47 48 49 50 49 50 49 50 49 50 51 52 53 54 53 54 53 54 53 54 53 54 53 54 53 54 53 54 53 54 53 54 53 54 53 54 53 54 53 54 53 54 53 54 36 37 36 37 36 37 36 37 36 37 53 54 53 54 53 54 53 54 53 54 27 28 36 37 36 37 27 28 27 28 27 28 27 28 27 28 36 37 53 54 53 54 27 28 36 37 36 37 27 28 27 28 27 28 27 28 27 28 27 28 27 28 27 28 27 28 27 28 27 28 36 37 36 37 36 37 36 37 27 28 27 28 27 0 0 0 0 0 0 0
0 0 45 46 45 46 45 46 45 46 45 46 45 46 45 46 45 46 45 46 45 46 45 46 45 46 45 46 45 46 45 46 45 46 45 46 45 46 45 46 45 46 45 46 45 46 45 46 0 0 0 0 0 0 0 0 45 46 45 46 45 46 45 46 45 46 0 0 0 0 0 0 0 0 45 46 45 46 45 46 45 46 45 46 45 46 45 46 45 46 55 56 55 56 55 56 55 56 55 56 55 56 55 56 55 56 55 56 55 56 55 56 55 56 55 56 45 46 45 46 45 46 45 46 45 46 45 46 45 46 55 56 55 56 55 56 55 56 27 28 45 46 45 46 27 28 27 28 27 28 27 28 27 28 45 46 45 46 55 56 27 28 45 46 45 46 27 28 27 28 27 28 27 28 27 28 27 28 27 28 27 28 27 28 27 28 27 28 45 46 45 46 45 46 45 46 27 28 27 28 27 0 0 0 0 0 0 0
0 0 53 54 53 54 53 54 53 54 53 54 53 54 53 54 53 54 53 54 53 54 53 54 53 54 53 54 53 54 53 54 53 54 53 54 53 54 53 54 53 54 53 54 53 54 53 54 0 0 0 0 0 0 0 0 53 54 53 54 53 54 53 54 53 54 0 0 0 0 0 0 0 0 53 54 53 54 53 54 53 54 53 54 53 54 53 54 53 54 57 58 57 58 57 58 57 58 57 58 57 58 57 58 57 58 57 58 57 58 57 58 57 58 57 58 53 54 53 54 53 54 53 54 53 54 53 54 53 54 57 58 57 58 57 58 57 58 36 37 53 54 53 54 27 28 36 37 36 37 27 28 27 28 53 54 53 54 57 58 27 28 53 54 53 54 36 37 36 37 36 37 36 37 27 28 27 28 27 28 27 28 27 28 36 37 36 37 53 54 53 54 53 54 53 54 36 37 27 28 27 0 0 0 0 0 0 0
59 59 55 56 55 56 55 56 55 56 45 46 45 46 45 46 55 56 55 56 55 56 55 56 55 56 45 46 45 46 55 56 55 56 55 56 55 56 55 56 55 56 55 56 55 56 55 56 59 59 59 59 59 59 59 59 55 56 55 56 55 56 55 56 55 56 59 59 59 59 59 59 59 59 55 56 55 56 55 56 55 56 55 56 55 56 55 56 55 56 55 56 55 56 55 56 55 56 55 56 45 46 45 46 45 46 45 46 45 46 45 46 45 46 55 56 55 56 55 56 55 56 55 56 55 56 55 56 55 56 55 56 55 56 55 56 45 46 45 46 45 46 55 56 27 28 45 46 45 46 27 28 27 28 55 56 55 56 55 56 27 28 55 56 45 46 45 46 45 46 45 46 45 46 27 28 27 28 27 28 27 28 27 28 45 46 45 46 55 56 55 56 55 56 55 56 45 46 27 28 27 0 0 0 0 0 0 0
59 59 57 58 57 58 57 58 57 58 53 54 53 54 53 54 57 58 57 58 57 58 57 58 57 58 53 54 53 54 57 58 57 58 57 58 57 58 57 58 45 46 45 46 45 46 57 58 59 59 59 59 59 59 59 59 57 58 57 58 57 58 57 58 57 58 59 59 59 59 59 59 59 59 57 58 57 58 57 58 57 58 57 58 57 58 57 58 57 58 57 58 57 58 45 46 45 46 57 58 53 54 53 54 53 54 53 54 53 54 53 54 53 54 57 58 57 58 57 58 57 58 57 58 57 58 57 58 57 58 57 58 45 46 57 58 53 54 53 54 53 54 57 58 27 28 53 54 53 54 36 37 36 37 57 58 57 58 45 46 27 28 57 58 53 54 53 54 53 54 53 54 53 54 27 28 27 28 36 37 36 37 27 28 53 54 53 54 57 58 45 46 45 46 45 46 53 54 36 37 27 0 0 0 0 0 0 0
59 60 55 56 55 56 55 56 55 56 55 56 55 56 55 56 45 46 55 56 55 56 45 46 55 56 55 56 55 56 55 56 55 56 55 56 55 56 55 56 61 62 61 62 61 62 55 56 63 59 59 59 59 59 59 60 55 56 55 56 55 56 55 56 55 56 63 59 59 59 59 59 59 60 55 56 55 56 55 56 55 56 55 56 55 56 55 56 55 56 55 56 55 56 61 62 61 62 55 56 55 56 55 56 55 56 55 56 55 56 55 56 55 56 55 56 55 56 55 56 45 46 45 46 55 56 45 46 45 46 55 56 61 62 55 56 55 56 55 56 55 56 55 56 27 28 55 56 45 46 45 46 45 46 55 56 55 56 61 62 27 28 55 56 55 56 55 56 55 56 55 56 55 56 27 28 27 28 45 46 45 46 27 28 55 56 55 56 55 56 61 62 61 62 55 56 55 56 45 46 27 0 0 0 0 0 0 0
59 64 65 66 65 66 65 66 65 67 57 58 57 58 57 58 53 54 57 58 57 58 53 54 68 67 57 58 57 58 68 66 65 66 65 67 57 58 57 58 57 58 57 58 57 58 68 66 69 59 59 59 59 59 59 64 65 66 65 66 65 66 65 66 65 66 69 59 59 59 59 59 59 64 65 66 65 67 57 58 57 58 57 58 57 58 57 58 57 58 57 58 57 58 57 58 57 58 68 67 57 58 57 58 57 58 57 58 57 58 57 58 57 58 57 58 57 58 57 58 53 54 53 54 57 58 53 54 53 54 57 58 57 58 57 58 57 58 57 58 57 58 57 58 27 28 57 58 53 54 53 54 53 54 57 58 57 58 57 58 27 28 57 58 57 58 57 58 57 58 57 58 57 58 36 37 27 28 53 54 53 54 27 28 57 58 57 58 57 58 57 58 57 58 57 58 57 58 53 54 36 0 0 0 0 0 0 0
59 59 59 59 59 59 59 59 59 64 65 66 65 66 65 66 65 70 45 46 45 46 71 66 69 64 65 66 65 66 69 59 59 59 59 64 65 70 45 46 45 46 71 66 65 66 69 59 59 59 59 59 59 59 59 59 59 59 59 59 59 59 59 59 59 59 59 59 59 59 59 59 59 59 59 59 59 64 65 66 65 66 65 66 65 66 65 70 45 46 45 46 45 46 71 66 65 66 69 64 65 66 65 66 65 66 65 70 45 46 45 46 45 46 45 46 45 46 45 46 55 56 55 56 55 56 55 56 55 56 55 56 55 56 55 56 55 56 55 56 55 56 55 56 27 28 45 46 55 56 55 56 55 56 55 56 45 46 55 56 27 28 55 56 55 56 55 56 55 56 45 46 45 46 45 46 27 28 55 56 55 56 27 28 55 56 55 56 45 46 45 46 45 46 45 46 45 46 45 46 45 72 73 0 0 0 0 0
59 59 59 59 59 59 59 59 59 59 59 59 59 59 59 59 59 64 65 66 65 66 69 59 59 59 59 59 59 59 59 59 59 59 59 59 59 64 65 66 65 66 69 59 59 59 59 59 59 59 59 59 59 59 59 59 59 59 59 59 59 59 59 59 59 59 59 59 59 59 59 59 59 59 59 59 59 59 59 59 59 59 59 59 59 59 59 64 65 66 65 66 65 66 69 59 59 59 59 59 59 59 59 59 59 59 59 64 65 66 74 54 53 54 53 54 53 54 53 54 57 58 57 58 57 58 57 58 57 58 57 58 57 58 57 58 57 58 57 58 57 58 57 58 27 28 53 54 57 58 57 58 57 58 57 58 53 54 57 58 27 28 57 58 57 58 57 58 57 58 53 54 53 54 53 54 27 28 57 58 57 58 27 28 57 58 57 58 53 54 53 54 53 54 53 54 53 54 53 54 53 54 53 0 0 0 0 0