208
15
0 0 0 0 0 0 0 0 0 0 0 0 0 0 0 0 0 0 0 0 0 0 0 0 0 0 0 0 0 0 0 0 0 0 0 0 0 0 0 0 0 0 0 0 0 0 0 0 0 0 0 0 0 0 0 0 0 0 0 0 0 0 0 0 0 0 0 0 0 0 0 0 0 0 0 0 0 0 0 0 0 0 0 0 0 0 0 0 0 0 0 0 0 0 0 0 0 0 0 0 0 0 0 0 0 0 0 0 0 0 0 0 0 0 0 0 0 0 0 0 0 0 0 0 0 0 0 0 0 0 0 0 0 0 0 0 0 0 0 0 0 0 0 0 0 0 0 0 0 0 0 0 0 0 0 0 0 0 0 0 0 0 0 0 0 0 0 0 0 0 0 0 0 0 0 0 0 0 0 0 0 0 0 0 0 0 0 0 0 0 0 0 0 0 0 0 0 0 0 0 0 0 0 0 0 0 0 0
1 1 1 2 1 1 2 3 4 0 5 3 4 0 0 3 1 1 1 2 2 3 4 0 5 3 4 0 5 3 4 0 5 3 4 0 5 3 4 0 0 3 0 0 1 1 0 0 1 1 1 2 0 0 1 1 1 2 1 2 0 0 1 1 0 0 0 0 0 0 1 2 1 1 0 0 1 2 2 3 4 0 0 3 1 2 6 7 8 7 8 7 8 7 8 7 8 7 8 7 8 7 8 7 8 7 8 7 8 7 8 7 8 7 8 7 8 7 8 7 8 7 8 7 8 7 8 7 8 7 8 7 8 7 8 7 8 7 8 7 8 7 8 7 8 7 8 7 8 7 8 7 8 7 8 7 8 7 8 7 8 7 8 7 8 7 8 7 8 7 8 7 8 7 8 7 8 7 8 7 8 7 8 7 8 7 8 7 8 7 8 7 8 7 8 7 8 7 9 0 0 0 0 0 0 0 0 0
5 4 5 1 5 4 5 10 11 12 13 10 11 12 13 1 5 4 5 1 5 10 11 12 13 10 11 12 13 10 11 12 13 10 11 12 13 10 11 12 13 1 0 0 5 4 0 0 5 4 5 1 0 0 5 4 5 1 5 1 0 0 5 4 0 0 0 0 0 0 5 1 5 4 0 0 5 1 5 10 11 12 13 1 5 1 14 15 16 15 16 15 16 15 16 15 16 15 16 15 16 15 16 15 16 15 16 15 16 15 16 15 16 15 16 15 16 15 16 15 16 15 16 15 16 15 16 15 16 15 16 15 16 15 16 15 16 15 16 15 16 15 16 15 16 15 16 15 16 15 16 15 16 15 16 15 16 15 16 15 16 15 17 18 17 18 17 18 17 18 17 18 17 18 17 18 17 18 17 18 17 18 17 18 17 18 17 18 17 18 17 18 17 18 17 18 17 18 19 20 0 0 0 0 0 0 0 0
1 2 0 0 0 0 21 22 23 24 25 22 23 24 26 0 0 0 0 0 21 22 23 24 25 22 23 24 25 22 23 24 25 22 23 24 25 22 23 24 26 0 1 1 1 2 0 0 0 0 0 0 1 1 1 2 1 1 1 1 0 0 0 0 1 2 1 2 0 0 1 1 0 0 0 0 0 0 21 22 23 24 26 0 1 1 27 28 27 28 27 28 27 28 27 28 27 28 27 28 27 28 27 28 27 28 27 28 27 28 27 28 27 28 27 28 27 28 27 28 27 28 27 28 27 28 27 28 27 28 27 28 27 28 27 28 27 28 27 28 27 28 27 28 27 28 27 28 27 28 27 28 27 28 27 28 27 28 27 28 27 28 29 7 8 7 8 7 8 7 8 7 8 7 8 7 8 7 8 7 8 7 8 7 8 7 8 7 8 7 8 7 8 7 8 7 8 7 8 7 30 31 32 33 34 35 35 35
5 1 0 0 0 0 36 37 38 39 36 40 38 39 0 0 0 0 0 0 36 37 38 39 36 40 38 39 36 40 38 39 36 40 38 39 36 40 38 39 0 0 5 4 5 1 0 0 0 0 0 0 5 4 5 1 5 4 5 4 0 0 0 0 5 1 5 1 0 0 5 4 0 0 0 0 0 0 36 37 38 39 0 0 5 4 41 42 41 42 41 42 41 42 41 42 41 42 41 42 41 42 41 42 41 42 41 42 41 42 41 42 41 42 41 42 41 42 27 28 27 28 27 28 27 28 27 28 41 42 41 42 41 42 41 42 41 42 27 28 27 28 27 28 27 28 27 28 27 28 27 28 27 28 27 28 41 42 41 42 27 28 43 44 16 15 16 15 16 15 16 15 16 15 16 15 16 15 16 15 16 15 16 15 16 15 16 15 16 15 16 15 16 15 16 15 16 15 16 15 45 46 47 48 49 50 50 50
0 0 51 52 52 53 52 54 51 52 52 54 51 52 51 52 52 53 52 53 52 53 52 54 51 52 52 53 52 53 52 54 52 54 51 52 52 53 52 53 51 52 52 53 52 53 52 54 0 0 1 2 0 0 0 0 51 52 52 53 52 53 52 53 52 54 0 0 0 0 0 0 0 0 51 52 52 53 52 53 52 53 52 53 52 54 55 56 55 56 55 56 55 56 55 56 55 56 55 56 55 56 55 56 55 56 55 56 55 56 55 56 55 56 55 56 55 56 27 28 27 28 27 28 27 28 27 28 55 56 55 56 55 56 55 56 55 56 27 28 27 28 27 28 27 28 27 28 27 28 27 28 27 28 27 28 55 56 55 56 27 28 27 28 27 28 27 28 27 28 27 28 27 28 27 28 27 28 27 28 27 28 27 28 27 28 27 28 27 28 27 28 27 28 27 28 27 28 27 28 27 57 58 48 49 59 59 59
0 0 60 61 62 63 64 65 60 61 64 65 60 61 60 61 62 63 62 63 62 63 64 65 60 61 62 63 62 63 64 65 64 65 60 61 62 63 62 63 60 61 62 63 62 63 64 65 0 0 5 1 0 0 0 0 60 61 62 63 62 63 62 63 64 65 0 0 0 0 0 0 0 0 60 61 62 63 62 63 62 63 62 63 64 65 66 67 66 67 66 67 66 67 66 67 66 67 66 67 66 67 66 67 66 67 66 67 66 67 66 67 66 67 66 67 66 67 41 42 41 42 41 42 41 42 41 42 66 67 66 67 66 67 66 67 66 67 27 28 41 42 41 42 27 28 27 28 27 28 27 28 27 28 41 42 66 67 66 67 27 28 41 42 41 42 27 28 27 28 27 28 27 28 27 28 27 28 27 28 27 28 27 28 27 28 27 28 41 42 41 42 41 42 41 42 27 28 27 28 27 68 69 70 49 59 59 59
0 0 55 56 55 56 55 56 55 56 55 56 55 56 55 56 55 56 55 56 55 56 55 56 55 56 55 56 55 56 55 56 55 56 55 56 55 56 55 56 55 56 55 56 55 56 55 56 0 0 0 0 0 0 0 0 55 56 55 56 55 56 55 56 55 56 0 0 0 0 0 0 0 0 55 56 55 56 55 56 55 56 55 56 55 56 55 56 55 56 71 72 71 72 71 72 71 72 71 72 71 72 71 72 71 72 71 72 71 72 71 72 71 72 71 72 55 56 55 56 55 56 55 56 55 56 55 56 55 56 71 72 71 72 71 72 71 72 27 28 55 56 55 56 27 28 27 28 27 28 27 28 27 28 55 56 55 56 71 72 27 28 55 56 55 56 27 28 27 28 27 28 27 28 27 28 27 28 27 28 27 28 27 28 27 28 27 28 55 56 55 56 55 56 55 56 27 28 27 28 27 73 74 75 49 59 59 59
0 0 66 67 66 67 66 67 66 67 66 67 66 67 66 67 66 67 66 67 66 67 66 67 66 67 66 67 66 67 66 67 66 67 66 67 66 67 66 67 66 67 66 67 66 67 66 67 0 0 0 0 0 0 0 0 66 67 66 67 66 67 66 67 66 67 0 0 0 0 0 0 0 0 66 67 66 67 66 67 66 67 66 67 66 67 66 67 66 67 76 77 76 77 76 77 76 77 76 77 76 77 76 77 76 77 76 77 76 77 76 77 76 77 76 77 66 67 66 67 66 67 66 67 66 67 66 67 66 67 76 77 76 77 76 77 76 77 41 42 66 67 66 67 27 28 41 42 41 42 27 28 27 28 66 67 66 67 76 77 27 28 66 67 66 67 41 42 41 42 41 42 41 42 27 28 27 28 27 28 27 28 27 28 41 42 41 42 66 67 66 67 66 67 66 67 41 42 27 28 27 78 79 80 49 59 59 59
81 81 71 72 71 72 71 72 71 72 55 56 55 56 55 56 71 72 71 72 71 72 71 72 71 72 55 56 55 56 71 72 71 72 71 72 71 72 71 72 71 72 71 72 71 72 71 72 81 81 81 81 81 81 81 81 71 72 71 72 71 72 71 72 71 72 81 81 81 81 81 81 81 81 71 72 71 72 71 72 71 72 71 72 71 72 71 72 71 72 71 72 71 72 71 72 71 72 71 72 55 56 55 56 55 56 55 56 55 56 55 56 55 56 71 72 71 72 71 72 71 72 71 72 71 72 71 72 71 72 71 72 71 72 71 72 55 56 55 56 55 56 71 72 27 28 55 56 55 56 27 28 27 28 71 72 71 72 71 72 27 28 71 72 55 56 55 56 55 56 55 56 55 56 27 28 27 28 27 28 27 28 27 28 55 56 55 56 71 72 71 72 71 72 71 72 55 56 27 28 27 82 83 84 85 86 86 86
81 81 76 77 76 77 76 77 76 77 66 67 66 67 66 67 76 77 76 77 76 77 76 77 76 77 66 67 66 67 76 77 76 77 76 77 76 77 76 77 55 56 55 56 55 56 76 77 81 81 81 81 81 81 81 81 76 77 76 77 76 77 76 77 76 77 81 81 81 81 81 81 81 81 76 77 76 77 76 77 76 77 76 77 76 77 76 77 76 77 76 77 76 77 55 56 55 56 76 77 66 67 66 67 66 67 66 67 66 67 66 67 66 67 76 77 76 77 76 77 76 77 76 77 76 77 76 77 76 77 76 77 55 56 76 77 66 67 66 67 66 67 76 77 27 28 66 67 66 67 41 42 41 42 76 77 76 77 55 56 27 28 76 77 66 67 66 67 66 67 66 67 66 67 27 28 27 28 41 42 41 42 27 28 66 67 66 67 76 77 55 56 55 56 55 56 66 67 41 42 27 87 88 89 49 59 59 59
81 90 71 72 71 72 71 72 71 72 71 72 71 72 71 72 55 56 71 72 71 72 55 56 71 72 71 72 71 72 71 72 71 72 71 72 71 72 71 72 91 92 91 92 91 92 71 72 93 81 81 81 81 81 81 90 71 72 71 72 71 72 71 72 71 72 93 81 81 81 81 81 81 90 71 72 71 72 71 72 71 72 71 72 71 72 71 72 71 72 71 72 71 72 91 92 91 92 71 72 71 72 71 72 71 72 71 72 71 72 71 72 71 72 71 72 71 72 71 72 55 56 55 56 71 72 55 56 55 56 71 72 91 92 71 72 71 72 71 72 71 72 71 72 27 28 71 72 55 56 55 56 55 56 71 72 71 72 91 92 27 28 71 72 71 72 71 72 71 72 71 72 71 72 27 28 27 28 55 56 55 56 27 28 71 72 71 72 71 72 91 92 91 92 71 72 71 72 55 56 27 94 95 96 49 59 59 59
81 97 98 99 98 99 98 99 98 100 76 77 76 77 76 77 66 67 76 77 76 77 66 67 101 100 76 77 76 77 101 99 98 99 98 100 76 77 76 77 76 77 76 77 76 77 101 99 102 81 81 81 81 81 81 97 98 99 98 99 98 99 98 99 98 99 102 81 81 81 81 81 81 97 98 99 98 100 76 77 76 77 76 77 76 77 76 77 76 77 76 77 76 77 76 77 76 77 101 100 76 77 76 77 76 77 76 77 76 77 76 77 76 77 76 77 76 77 76 77 66 67 66 67 76 77 66 67 66 67 76 77 76 77 76 77 76 77 76 77 76 77 76 77 27 28 76 77 66 67 66 67 66 67 76 77 76 77 76 77 27 28 76 77 76 77 76 77 76 77 76 77 76 77 41 42 27 28 66 67 66 67 27 28 76 77 76 77 76 77 76 77 76 77 76 77 76 77 66 67 41 103 104 105 49 59 59 59
81 81 81 81 81 81 81 81 81 97 98 99 98 99 98 99 98 106 55 56 55 56 107 99 102 97 98 99 98 99 102 81 81 81 81 97 98 106 55 56 55 56 107 99 98 99 102 81 81 81 81 81 81 81 81 81 81 81 81 81 81 81 81 81 81 81 81 81 81 81 81 81 81 81 81 81 81 97 98 99 98 99 98 99 98 99 98 106 55 56 55 56 55 56 107 99 98 99 102 97 98 99 98 99 98 99 98 106 55 56 55 56 55 56 55 56 55 56 55 56 71 72 71 72 71 72 71 72 71 72 71 72 71 72 71 72 71 72 71 72 71 72 71 72 27 28 55 56 71 72 71 72 71 72 71 72 55 56 71 72 27 28 71 72 71 72 71 72 71 72 55 56 55 56 55 56 27 28 71 72 71 72 27 28 71 72 71 72 55 56 55 56 55 56 55 56 55 56 55 56 55 56 55 85 108 59 59 59
81 81 81 81 81 81 81 81 81 81 81 81 81 81 81 81 81 97 98 99 98 99 102 81 81 81 81 81 81 81 81 81 81 81 81 81 81 97 98 99 98 99 102 81 81 81 81 81 81 81 81 81 81 81 81 81 81 81 81 81 81 81 81 81 81 81 81 81 81 81 81 81 81 81 81 81 81 81 81 81 81 81 81 81 81 81 81 97 98 99 98 99 98 99 102 81 81 81 81 81 81 81 81 81 81 81 81 97 98 99 109 67 66 67 66 67 66 67 66 67 76 77 76 77 76 77 76 77 76 77 76 77 76 77 76 77 76 77 76 77 76 77 76 77 27 28 66 67 76 77 76 77 76 77 76 77 66 67 76 77 27 28 76 77 76 77 76 77 76 77 66 67 66 67 66 67 27 28 76 77 76 77 27 28 76 77 76 77 66 67 66 67 66 67 66 67 66 67 66 67 66 67 66 49 59 59 59 59