319
15
0 0 0 0 0 0 0 0 0 0 0 0 0 0 0 0 0 0 0 0 0 0 0 0 0 0 0 0 0 0 0 0 0 0 0 0 0 0 0 0 0 0 0 0 0 0 0 0 0 0 0 0 0 0 0 0 0 0 0 0 0 0 0 0 0 0 0 0 0 0 0 0 0 0 0 0 0 0 0 0 0 0 0 0 0 0 0 0 0 0 0 0 0 0 0 0 0 0 0 0 0 0 0 0 0 0 0 0 0 0 0 0 0 0 0 0 0 0 0 0 0 0 0 0 0 0 0 0 0 0 0 0 0 0 0 0 0 0 0 0 0 0 0 0 0 0 0 0 0 0 0 0 0 0 0 0 0 0 0 0 0 0 0 0 0 0 0 0 0 0 0 0 0 0 0 0 0 0 0 0 0 0 0 0 0 0 0 0 0 0 0 0 0 0 0 0 0 0 0 0 0 0 0 0 0 0 0 0 0 0 0 0 0 0 0 0 0 0 0 0 0 0 0 0 0 0 0 0 0 0 0 0 0 0 0 0 0 0 0 0 0 0 0 0 0 0 0 0 0 0 0 0 0 0 0 0 0 0 0 0 0 0 0 0 0 0 0 0 0 0 0 0 0 0 0 0 0 0 0 0 0 0 0 0 0 0 0 0 0 0 0 0 0 0 0 0 0 0 0 0 0 0 0 0 0 0 0 0 0 0 0 0 0 0 0 0 0 0 0
0 0 0 0 1 2 0 0 3 4 1 2 0 0 0 0 0 0 1 2 3 4 1 2 0 0 3 4 0 0 0 0 0 0 0 0 3 4 0 0 0 0 1 2 3 4 0 0 0 0 3 4 1 2 1 2 0 0 3 4 1 2 0 0 0 0 3 4 1 2 3 4 1 2 0 0 0 5 6 0 1 2 0 0 3 4 0 5 6 5 6 0 0 0 0 0 0 0 3 4 1 2 0 0 0 0 1 2 3 4 0 0 0 0 0 0 3 4 1 2 0 0 3 4 0 0 1 2 0 0 0 0 0 0 0 0 0 0 1 2 0 0 0 0 0 0 0 0 0 0 0 0 0 0 0 0 0 0 0 0 0 0 0 0 0 0 0 0 0 0 0 0 0 0 0 0 0 0 0 0 0 0 0 0 0 0 0 0 0 0 1 2 0 0 3 4 0 0 0 0 0 0 0 0 0 0 0 0 0 0 0 0 0 0 0 0 0 0 0 0 0 0 0 0 0 0 0 0 0 0 0 0 0 0 0 0 0 0 0 1 2 0 0 1 2 3 4 0 0 3 4 1 2 0 0 0 0 0 0 0 0 3 4 1 2 0 0 1 2 0 0 0 0 3 4 1 2 0 0 0 0 0 0 0 0 1 2 0 0 0 0 0 0 0 0 0 0 0 0 0 0 0 0 0 0 0 0 0 0 0 0 0 0 0 0 0 0 0 0
0 0 0 0 4 3 0 0 0 0 4 3 0 0 0 0 0 0 4 3 0 0 4 3 0 0 0 0 0 0 0 0 0 0 0 0 0 0 0 0 0 0 4 3 0 0 0 0 0 0 0 0 4 3 4 3 0 0 0 0 4 3 0 0 0 0 0 0 4 3 0 0 4 3 0 0 7 8 9 10 4 3 0 0 0 0 7 8 9 8 9 10 0 0 0 0 0 0 0 0 4 3 0 0 0 0 4 3 0 0 0 0 0 0 0 0 0 0 4 3 0 0 0 0 0 0 4 3 0 0 0 0 0 0 0 0 0 0 4 3 0 0 0 0 0 0 0 0 0 0 0 0 0 0 0 0 0 0 0 0 0 0 0 0 0 0 0 0 0 0 0 0 0 0 0 0 0 0 0 0 0 0 0 0 0 0 0 0 0 0 4 3 0 0 0 0 0 0 0 0 0 0 0 0 0 0 0 0 0 0 0 0 0 0 0 0 0 0 0 0 0 0 0 0 0 0 0 0 0 0 0 0 0 0 0 0 0 0 0 4 3 0 0 4 3 0 0 0 0 0 0 4 3 0 0 0 0 0 0 0 0 0 0 4 3 0 0 4 3 0 0 0 0 0 0 4 3 0 0 0 0 0 0 0 0 4 3 0 0 0 0 0 0 0 0 0 0 0 0 0 0 0 0 0 0 0 0 0 0 0 0 0 0 0 0 0 0 0 0
0 0 1 2 0 0 1 2 1 2 1 2 3 4 0 0 0 5 6 5 6 5 6 5 6 5 6 5 6 5 6 0 0 0 0 0 0 0 1 2 3 4 3 4 1 2 0 0 0 0 0 0 1 2 1 2 1 2 0 0 0 0 0 0 0 0 1 2 0 0 3 4 0 0 0 0 11 12 13 14 3 4 1 2 0 0 11 12 13 12 13 14 0 0 0 0 0 0 1 2 0 0 0 0 3 4 3 4 1 2 0 0 0 0 3 4 1 2 1 2 0 0 1 2 3 4 1 2 0 0 1 2 0 0 0 0 1 2 0 0 0 0 0 0 0 0 0 0 0 0 0 0 0 0 0 0 0 0 0 0 0 0 0 0 0 0 0 0 0 0 0 0 0 0 0 0 0 0 0 0 0 0 0 0 0 0 3 4 0 0 1 2 0 0 1 2 0 0 0 0 0 0 0 0 0 0 0 0 0 0 0 0 0 0 0 0 0 0 0 0 0 0 0 0 0 0 0 0 0 0 0 0 0 0 0 0 0 0 0 0 0 3 4 0 5 6 5 6 5 6 5 6 0 1 2 3 4 0 0 3 4 1 2 0 0 0 0 0 0 0 0 0 0 0 0 0 0 3 4 0 0 3 4 0 0 0 0 0 0 0 0 0 0 0 0 0 0 0 0 0 0 0 0 0 0 0 0 0 0 0 0 0 0 0 0 0 0 0 0
0 0 4 3 0 0 4 3 4 3 4 3 0 0 0 0 7 8 9 8 9 8 9 8 9 8 9 8 9 8 9 10 0 0 0 0 0 0 4 3 0 0 0 0 4 3 0 0 0 0 0 0 4 3 4 3 4 3 0 0 0 0 0 0 0 0 4 3 0 0 0 0 0 0 0 0 11 12 13 14 0 0 4 3 0 0 11 12 13 12 13 14 0 0 0 0 0 0 4 3 0 0 0 0 0 0 0 0 4 3 0 0 0 0 0 0 4 3 4 3 0 0 4 3 0 0 4 3 0 0 4 3 0 0 0 0 4 3 0 0 0 0 0 0 0 0 0 0 0 0 0 0 0 0 0 0 0 0 0 0 0 0 0 0 0 0 0 0 0 0 0 0 0 0 0 0 0 0 0 0 0 0 0 0 0 0 0 0 0 0 4 3 0 0 4 3 0 0 0 0 0 0 0 0 0 0 0 0 0 0 0 0 0 0 0 0 0 0 0 0 0 0 0 0 0 0 0 0 0 0 0 0 0 0 0 0 0 0 0 0 0 0 0 7 8 9 8 9 8 9 8 9 10 4 3 0 0 0 0 0 0 4 3 0 0 0 0 0 0 0 0 0 0 0 0 0 0 0 0 0 0 0 0 0 0 0 0 0 0 0 0 0 0 0 0 0 0 0 0 0 0 0 0 0 0 0 0 0 0 0 0 0 0 0 0 0 0 0 0
0 0 1 2 3 4 3 4 3 4 1 2 0 0 0 0 11 12 13 12 13 12 13 12 13 12 13 12 13 12 13 14 0 0 1 2 3 4 0 0 0 0 0 0 1 2 0 0 0 0 3 4 0 0 3 4 0 0 0 0 0 0 0 0 0 0 0 0 0 0 0 0 0 0 0 0 15 16 17 0 0 0 0 0 0 0 15 16 15 16 17 0 0 0 0 0 0 0 0 0 0 0 0 0 0 0 0 0 0 0 0 0 0 0 1 2 0 0 0 0 0 0 0 0 0 0 0 0 0 0 0 0 0 0 0 0 1 2 0 0 0 0 0 0 0 0 0 0 0 0 0 0 0 0 0 0 0 0 0 0 0 0 0 0 0 0 0 0 0 0 0 0 0 0 0 0 0 0 0 0 0 0 0 0 3 4 1 2 0 0 3 4 0 0 0 0 0 0 0 0 0 0 0 0 0 0 0 0 0 0 0 0 0 0 0 0 0 0 0 0 0 0 0 0 0 0 0 0 0 0 0 0 0 0 0 0 0 0 0 0 0 1 2 11 12 13 12 13 12 13 12 13 14 0 0 0 0 0 0 0 0 0 0 0 0 3 4 0 0 0 0 0 0 0 0 3 4 0 0 1 2 1 2 0 0 0 0 0 0 0 0 0 0 0 0 0 0 0 0 0 0 0 0 0 0 0 0 0 0 0 0 0 0 0 0 0 0 0 0
0 0 4 3 0 0 0 0 0 0 4 3 0 0 0 0 11 12 13 12 13 12 13 12 13 12 13 12 13 12 13 14 0 0 4 3 0 0 0 0 0 0 0 0 4 3 0 0 0 0 0 0 0 0 0 0 0 0 0 0 18 19 20 21 20 21 20 22 0 0 0 0 0 23 20 21 24 19 24 19 20 22 0 0 18 19 24 19 24 19 24 19 20 22 0 0 0 0 18 19 20 21 20 21 20 22 0 0 0 0 0 0 0 0 4 3 0 0 0 0 0 0 0 0 0 0 0 0 0 0 0 0 0 0 0 0 4 3 0 0 0 0 0 0 0 0 0 0 0 0 0 0 0 0 0 0 0 0 0 0 0 0 0 0 0 0 0 0 0 0 0 0 0 0 0 0 0 0 0 0 0 0 0 0 0 0 4 3 0 0 0 0 0 0 0 0 0 0 0 0 0 0 0 0 0 0 0 0 0 0 0 0 0 0 0 0 0 0 0 0 0 0 0 0 0 0 0 0 0 0 0 0 0 0 0 0 0 0 0 0 0 4 3 11 12 13 12 13 12 13 12 13 14 0 0 0 0 0 0 0 0 0 0 0 0 0 0 0 0 0 0 0 0 0 0 0 0 0 0 4 3 4 3 0 0 0 0 0 0 0 0 0 0 0 0 0 0 0 0 0 0 0 0 0 0 0 0 0 0 0 0 0 0 25 26 27 28 29 0
0 0 0 0 0 0 1 2 0 0 0 0 1 2 0 0 15 16 15 16 15 16 15 16 15 16 15 16 15 16 15 30 0 0 0 0 18 19 20 21 20 21 22 0 0 0 0 0 0 0 0 0 0 0 0 0 0 0 0 0 31 32 31 32 31 32 31 33 0 0 0 0 0 34 31 32 31 32 31 32 31 33 0 0 31 32 31 32 31 32 31 32 31 33 0 0 0 0 35 36 37 36 31 32 31 38 0 0 0 0 23 21 39 22 0 0 0 0 0 0 0 0 0 0 0 0 23 21 39 22 0 0 0 0 0 0 0 0 0 0 0 0 0 0 0 0 0 0 0 0 0 0 0 0 0 0 0 0 0 0 0 0 0 0 0 0 0 0 0 0 0 0 0 0 0 0 0 0 0 0 0 0 0 0 0 0 0 0 0 0 0 0 0 0 0 0 0 0 0 0 0 0 0 0 0 0 0 0 0 0 0 0 0 0 0 0 0 0 0 0 0 0 0 0 0 0 0 0 0 0 0 0 0 0 0 0 0 0 0 3 4 0 0 15 16 15 16 15 16 15 16 15 30 0 0 18 19 20 21 24 19 20 21 24 19 20 21 20 22 0 0 0 0 0 0 0 0 0 0 0 0 0 0 0 0 0 0 0 0 0 0 0 0 0 0 0 0 0 0 0 0 0 0 0 0 0 0 0 0 0 0 0 0 40 41 42 43 44 45
0 0 0 0 0 0 4 3 0 0 0 0 4 3 0 0 46 47 46 47 46 47 46 47 46 47 46 47 46 47 46 30 0 0 0 0 48 32 31 32 31 32 38 0 0 0 0 0 0 0 0 0 0 0 0 0 0 0 0 0 49 50 51 50 51 50 51 52 0 0 0 0 0 53 51 50 37 36 37 36 51 52 0 0 49 50 51 50 51 50 51 50 51 52 0 0 0 0 54 55 56 55 37 36 37 33 18 19 20 22 57 58 59 60 0 0 0 0 0 0 0 0 0 0 0 0 57 58 59 60 0 0 0 0 0 0 0 0 0 0 0 0 0 0 0 0 0 0 0 0 0 0 0 0 0 0 0 0 0 0 0 0 0 0 0 0 0 0 0 0 0 0 0 0 0 0 0 0 0 0 0 0 0 0 0 0 18 19 20 21 20 22 0 0 0 0 0 0 0 0 0 0 0 0 0 0 0 0 0 0 0 0 0 0 0 0 0 0 0 0 0 0 0 0 0 0 0 0 0 0 0 0 0 0 0 0 0 0 0 0 0 0 0 46 47 46 47 46 47 46 47 46 30 0 0 48 32 31 32 31 32 31 32 31 32 31 32 31 38 0 0 0 0 0 0 0 0 0 0 0 0 0 0 0 0 0 0 0 0 0 0 0 0 0 0 0 0 0 0 0 0 0 0 0 0 0 0 0 0 0 0 0 0 61 62 63 64 65 66
20 21 24 19 20 21 24 19 20 21 24 19 20 21 24 19 20 21 24 19 20 21 24 19 20 21 24 19 20 21 24 19 20 21 39 22 35 36 37 36 37 36 33 0 0 0 23 21 20 21 20 21 20 22 0 0 0 0 18 19 20 21 20 21 24 19 20 21 24 19 20 21 24 19 39 22 35 67 37 33 23 21 24 19 20 21 24 19 20 21 24 19 39 22 0 0 0 0 35 67 37 36 37 36 31 33 31 32 31 68 35 36 37 33 0 0 23 21 39 22 0 0 23 22 0 0 35 36 37 33 0 0 23 21 24 19 20 21 24 19 39 22 0 0 0 0 0 0 0 0 0 0 0 0 0 0 0 0 0 0 0 0 0 0 0 0 0 0 0 0 0 0 0 0 0 0 0 0 0 0 0 0 0 0 0 0 31 32 31 32 31 68 0 0 23 21 39 22 0 0 0 0 0 0 0 0 0 0 0 0 0 0 0 0 0 0 0 0 0 0 0 0 0 0 0 0 0 0 0 0 0 0 0 0 0 0 0 0 0 0 0 18 19 24 19 20 21 24 19 20 21 20 22 0 0 35 36 37 36 37 36 37 36 37 36 37 36 37 33 23 21 24 19 20 21 24 19 20 21 24 19 20 21 39 22 0 0 0 0 0 0 0 0 0 0 0 0 0 0 0 0 0 0 0 0 0 0 0 0 0 0 0 0 69 70 71 72 73 74
31 32 31 32 31 32 31 32 31 32 31 32 31 32 31 32 31 32 31 32 31 32 31 32 31 32 31 32 31 32 31 32 31 32 59 60 54 55 56 55 56 55 75 0 0 0 57 58 31 32 31 32 31 38 0 0 0 0 48 32 31 32 31 32 31 32 31 32 31 32 31 32 31 32 59 60 76 77 78 52 57 58 31 32 31 32 31 32 31 32 31 32 59 60 0 0 0 0 76 77 78 79 78 79 51 52 49 50 51 80 54 55 56 81 0 0 57 58 59 60 0 0 31 32 0 0 54 55 56 81 0 0 57 58 31 32 31 32 31 32 59 60 0 0 0 0 0 0 0 0 0 0 0 0 0 0 0 0 0 0 0 0 0 0 0 0 0 0 0 0 0 0 0 0 0 0 0 0 0 0 0 0 0 0 0 0 49 50 51 50 51 80 0 0 57 58 59 60 0 0 0 0 0 0 0 0 0 0 0 0 0 0 0 0 0 0 0 0 0 0 0 0 0 0 0 0 0 0 0 0 0 0 0 0 0 0 0 0 0 0 0 48 32 31 32 31 32 31 32 31 32 31 38 0 0 54 55 56 55 56 55 56 55 56 55 56 55 56 81 57 58 31 32 31 32 31 32 31 32 31 32 31 32 59 60 0 0 0 0 0 0 0 0 0 0 0 0 0 0 0 0 0 0 0 0 0 0 0 0 0 0 0 0 82 83 84 85 86 87
37 36 37 36 37 36 37 36 37 36 37 36 37 36 37 36 37 36 37 36 37 36 37 36 37 36 37 36 37 36 37 36 37 36 88 33 49 50 89 90 89 90 91 0 0 0 35 36 37 36 37 33 51 92 0 0 0 0 49 50 35 67 37 36 37 36 37 36 37 36 37 36 37 36 37 33 0 0 0 0 35 67 37 36 37 36 37 36 88 33 35 36 37 33 0 0 0 0 23 21 24 19 20 21 24 19 20 21 39 22 35 36 37 33 93 93 35 36 37 33 93 93 35 36 93 93 35 36 37 33 93 93 35 36 37 36 37 36 37 36 37 33 94 95 96 96 94 95 96 96 94 95 96 96 94 95 96 96 94 95 96 96 94 95 96 96 94 95 96 96 94 95 96 97 96 96 96 97 96 96 96 96 23 21 24 19 20 21 24 19 20 21 39 22 35 36 37 33 96 96 94 95 96 96 94 95 96 96 94 95 96 96 94 95 96 96 94 95 96 96 94 95 96 96 94 95 96 96 96 98 96 96 96 98 96 96 96 96 96 96 96 49 50 51 50 51 36 37 36 37 36 37 33 0 0 49 50 89 90 89 90 89 90 89 90 89 90 89 90 35 36 37 36 37 36 37 36 37 36 37 36 37 36 37 33 98 96 96 96 98 96 96 96 98 96 96 96 98 96 96 96 96 96 96 96 96 96 96 96 96 96 96 99 100 101 102 103 104 104
78 79 78 79 78 79 78 79 78 79 78 79 78 79 78 79 78 79 78 79 78 79 78 79 78 79 78 79 78 79 78 79 78 79 50 81 39 21 24 19 24 19 20 21 20 22 54 55 78 79 78 52 20 21 20 21 20 21 39 21 76 77 78 79 78 79 78 79 78 79 78 79 78 79 78 52 0 0 0 0 76 77 78 79 78 79 78 79 50 81 54 55 56 81 0 0 0 0 57 58 31 32 31 32 31 32 31 32 59 60 54 55 56 81 105 105 54 55 56 81 105 105 54 55 105 105 54 55 56 81 105 105 54 55 56 55 56 55 56 55 56 81 106 106 106 106 106 106 106 106 106 106 106 106 106 106 106 106 106 106 106 106 106 106 106 106 106 106 106 106 106 106 106 106 106 106 106 106 106 106 106 106 57 58 31 32 31 32 31 32 31 32 59 60 54 55 56 81 106 106 106 106 106 106 106 106 106 106 106 106 106 106 106 106 106 106 106 106 106 106 106 106 106 106 106 106 106 106 106 106 106 106 106 106 106 106 106 106 106 106 106 39 21 20 21 22 107 78 79 78 79 78 52 18 19 39 21 24 19 24 19 24 19 24 19 24 19 20 22 54 55 78 79 78 79 78 79 78 79 78 79 78 79 78 52 106 106 106 106 106 106 106 106 106 106 106 106 106 106 106 106 106 106 106 106 106 106 106 106 106 106 106 106 106 106 106 106 106 106
108 109 108 109 108 109 108 109 108 109 108 109 108 109 108 109 108 109 108 109 108 109 108 109 108 109 108 109 108 109 108 109 108 109 110 111 31 32 31 32 31 32 31 32 31 68 111 112 108 109 113 6 31 32 31 32 31 32 31 68 114 115 108 109 108 109 108 109 108 109 108 109 108 109 108 109 108 109 108 109 108 109 108 109 108 109 108 109 110 111 35 67 88 33 23 21 39 22 35 36 37 36 37 36 37 36 37 36 37 33 35 36 37 33 116 117 118 119 118 119 120 121 118 119 116 117 118 119 118 119 120 121 35 36 122 123 122 123 122 123 37 33 96 96 96 96 96 96 96 96 96 96 96 96 96 96 96 96 96 96 96 96 96 96 96 96 96 96 96 96 96 96 96 96 96 96 96 96 96 96 96 96 35 67 37 36 37 36 37 36 37 36 37 33 35 36 37 33 96 96 96 96 96 96 96 96 96 96 96 96 96 96 96 96 96 96 96 96 96 96 96 96 96 96 96 96 96 96 96 96 96 96 96 96 96 96 96 96 96 96 96 35 36 31 32 33 124 108 109 108 109 113 6 125 126 31 68 31 68 31 68 31 68 31 68 31 68 31 68 111 112 108 109 108 109 108 109 108 109 108 109 108 109 113 6 96 96 96 96 96 96 96 96 96 96 96 96 96 96 96 96 96 96 96 96 96 96 96 96 96 96 96 96 96 96 96 96 96 96
127 128 127 128 127 128 127 128 127 128 127 128 127 128 127 128 127 128 127 128 127 128 127 128 127 128 127 128 127 128 127 128 127 128 129 10 49 50 51 50 51 50 51 50 51 80 7 130 127 128 131 14 49 50 51 50 51 50 51 80 132 130 127 128 127 128 127 128 127 128 127 128 127 128 127 128 127 128 127 128 127 128 127 128 127 128 127 128 129 10 76 77 50 81 57 58 59 60 54 55 56 55 56 55 56 55 56 55 56 81 54 55 56 81 133 134 134 135 134 135 135 136 134 135 133 134 134 135 134 135 135 136 54 55 137 138 137 138 137 138 56 81 106 106 106 106 106 106 106 106 106 106 106 106 106 106 106 106 106 106 106 106 106 106 106 106 106 106 106 106 106 106 106 106 106 106 106 106 106 106 106 106 76 77 78 79 78 79 78 79 78 79 78 52 54 55 56 81 106 106 106 106 106 106 106 106 106 106 106 106 106 106 106 106 106 106 106 106 106 106 106 106 106 106 106 106 106 106 106 106 106 106 106 106 106 106 106 106 106 106 106 54 55 37 36 75 139 127 128 127 128 131 14 49 140 51 80 51 80 51 80 51 80 51 80 51 80 51 80 7 130 127 128 127 128 127 128 127 128 127 128 127 128 131 14 106 106 106 106 106 106 106 106 106 106 106 106 106 106 106 106 106 106 106 106 106 106 106 106 106 106 106 106 106 106 106 106 106 106