160 8
129
0 0 1 0 2 1 0 0 0 1 2 1 0 2 0 0 0 0 2 0 0 1 2 0 0 2 1 1 0 2 1 0 0 2 1 2 1 0 3 4 1 0 2 3 5 4 0 0 0 2 1 0 0 1 2 0 0 0 2 1 0 2 0 1 0 0 0 0 0 1 0 0 0 0 0 0 0 0 0 0 0 0 0 0 0 0 0 0 0 0 0 0 0 0 0 1 0 2 0 0 0 0 0 0 0 0 0 0 0 0 0 0 0 0 0 0 0 0 0 6 7 6 8 9 10 11 7 0 0 0 10 11 7 6 7 0 10 11 7 0 0 0 6 7 0 0 0 0 0 0 0 0 0 0 0 0 0 0 0 12 
0 1 0 1 1 1 2 0 3 5 5 5 5 5 5 4 0 0 0 1 2 2 1 0 0 0 1 1 1 0 0 0 0 1 0 2 0 0 13 14 2 1 0 13 15 14 0 0 0 1 0 0 2 2 1 0 0 2 1 1 0 1 2 1 0 1 0 0 1 0 0 0 0 0 0 0 0 0 0 0 0 0 0 0 0 0 0 0 0 0 0 0 0 2 0 1 0 1 0 0 0 0 0 0 0 0 0 0 0 0 0 0 0 0 0 0 0 0 0 0 10 16 17 17 17 17 18 8 9 10 11 7 0 0 0 0 0 0 10 9 10 9 0 0 0 0 0 0 0 0 0 0 0 0 0 0 0 0 0 12 
0 1 2 2 2 1 0 0 13 15 15 15 15 15 15 14 0 1 2 0 0 0 1 0 0 2 0 2 0 0 19 20 20 21 0 0 22 20 23 24 21 0 19 23 23 24 21 0 0 19 20 20 21 0 0 0 0 1 0 0 0 0 0 0 0 0 0 0 1 0 0 0 0 0 0 0 0 0 0 0 0 0 0 0 0 0 0 0 0 0 0 0 2 1 0 2 0 0 0 0 0 0 0 0 0 0 0 0 0 0 0 0 0 0 0 0 0 0 0 0 6 25 26 26 26 26 27 0 0 0 0 0 10 9 0 0 0 10 9 6 28 7 0 0 0 0 0 0 0 0 0 0 0 0 0 0 29 30 31 12 
0 0 0 1 0 0 1 0 32 32 32 32 32 32 32 33 0 0 34 35 35 36 0 0 0 0 0 0 0 0 37 38 38 39 0 0 40 38 41 41 39 0 37 38 38 38 39 0 0 42 43 41 44 19 21 45 46 0 0 0 0 0 0 45 46 0 0 0 0 0 0 0 0 0 0 0 0 0 0 0 0 0 0 0 0 0 0 0 0 0 0 0 0 19 20 21 0 0 0 0 0 0 0 0 0 0 0 0 0 0 0 0 0 0 0 0 0 0 0 10 9 47 48 48 48 48 49 50 51 52 51 52 51 53 36 0 0 0 0 0 0 0 0 0 0 0 0 0 0 0 0 0 0 0 0 0 54 55 56 57 
35 58 35 58 35 58 35 58 35 58 35 58 35 58 35 58 35 46 42 43 43 59 0 45 35 35 60 0 0 34 35 35 58 35 58 35 58 46 61 62 45 58 35 58 35 58 46 0 0 61 63 63 39 37 64 42 65 0 45 46 0 66 0 42 65 0 45 58 35 58 46 0 0 0 0 0 0 0 0 0 0 0 0 0 0 0 0 0 0 0 0 0 0 37 38 64 0 45 46 0 0 0 0 0 0 0 0 0 0 0 0 0 0 0 0 0 0 0 0 0 50 67 51 52 51 53 36 68 69 69 69 69 69 69 70 71 51 52 51 52 51 72 73 0 0 0 0 0 0 0 0 0 0 0 0 0 74 75 76 77 
63 63 63 63 63 63 63 63 63 63 63 63 63 63 63 63 63 78 79 80 80 81 21 42 63 62 82 20 20 79 61 63 63 63 63 63 63 62 0 0 61 63 63 63 78 42 65 0 0 45 58 35 58 35 46 42 65 83 42 65 83 42 83 42 65 83 42 43 43 43 65 84 85 84 85 84 85 84 85 84 85 84 85 84 85 84 86 85 86 85 85 45 58 35 58 35 46 42 65 85 84 85 84 85 84 85 84 85 84 85 84 85 84 85 87 85 87 85 85 85 88 89 90 91 92 92 93 94 95 96 96 96 96 97 98 99 92 92 92 92 92 92 100 85 87 85 87 85 87 85 85 85 85 85 85 85 101 102 103 104 
105 105 105 105 105 105 105 105 105 105 105 105 105 105 105 105 105 106 37 38 38 38 64 107 105 108 37 38 38 64 109 105 105 105 105 105 105 105 105 105 105 105 105 105 106 61 78 45 46 42 43 43 43 43 65 42 65 110 111 111 112 111 110 111 111 112 42 113 113 113 65 85 85 85 85 85 85 85 85 85 85 85 85 85 85 85 85 85 85 85 85 61 63 63 63 63 62 42 65 85 85 85 85 85 85 85 85 85 85 85 85 85 85 85 85 85 85 85 85 85 114 115 116 117 118 119 120 121 122 122 122 122 122 122 123 124 118 118 118 118 118 119 125 85 85 85 85 85 85 85 85 85 85 85 85 85 85 85 85 126 
127 127 127 127 127 127 127 127 127 127 127 127 127 127 127 127 127 127 127 127 127 127 127 127 127 127 127 127 127 127 127 127 127 127 127 127 127 127 127 127 127 127 127 127 127 127 127 127 127 127 127 127 127 127 127 127 127 127 127 127 127 127 127 127 127 127 127 127 127 127 127 127 127 127 127 127 127 127 127 127 127 127 127 127 127 127 127 127 127 127 127 127 127 127 127 127 127 127 127 127 127 127 127 127 127 127 127 127 127 127 127 127 127 127 127 127 127 127 127 127 127 127 127 127 127 127 127 127 127 127 127 127 127 127 127 127 127 127 127 127 127 127 127 127 127 127 127 127 127 127 127 127 127 127 127 127 127 127 127 128 
