108 8
158
0 0 0 0 0 0 0 0 0 0 0 0 0 0 0 0 0 0 0 0 0 0 0 0 0 0 0 0 0 0 0 0 0 0 0 0 0 0 0 0 0 0 0 0 0 0 0 0 0 0 0 0 0 0 0 0 0 0 0 0 0 0 0 0 0 0 0 0 0 0 0 0 0 0 0 0 0 0 0 0 0 0 0 0 0 0 0 0 0 0 0 0 0 0 0 0 0 0 0 0 0 0 0 0 0 0 0 0 
1 2 1 3 4 5 4 6 1 2 3 4 5 7 5 4 5 4 5 4 6 0 1 0 1 2 0 8 2 2 0 1 0 0 0 9 10 0 9 11 12 13 9 14 15 15 15 15 15 15 15 15 15 15 15 15 15 15 15 15 15 15 15 15 15 15 15 15 15 15 15 15 15 15 15 15 15 15 15 15 15 16 15 15 15 17 18 18 18 18 18 18 18 18 18 18 18 18 18 18 18 18 18 19 0 0 0 0 
2 0 0 20 21 22 21 23 0 0 20 21 22 21 22 21 22 21 22 21 23 1 2 0 0 0 1 2 1 1 0 0 2 2 0 10 0 0 0 24 25 26 10 27 28 28 28 28 28 28 28 28 28 28 28 28 28 28 28 29 30 30 30 30 31 28 28 28 28 29 30 30 30 30 30 30 30 30 30 30 30 30 27 28 29 32 15 15 15 15 15 15 15 15 15 15 15 15 15 15 15 15 15 15 33 34 35 36 
0 37 38 39 40 39 40 40 38 38 38 39 40 38 38 39 41 40 38 38 40 38 38 39 0 2 0 0 40 38 38 38 42 0 0 0 0 43 44 45 46 44 47 48 49 49 49 49 49 49 49 49 49 49 49 49 49 49 49 50 28 28 28 28 51 49 49 49 49 52 27 28 29 30 27 28 29 30 30 30 30 27 53 49 52 27 28 29 30 30 30 30 30 30 30 30 30 30 27 28 28 28 29 30 54 55 56 57 
0 58 58 58 58 58 58 58 58 58 58 58 58 58 58 58 59 58 58 58 58 58 58 58 60 61 61 62 58 58 58 58 58 60 61 61 62 63 64 65 66 49 49 49 49 67 68 68 68 68 68 69 70 68 68 68 68 69 71 49 49 49 49 49 49 67 68 68 68 72 53 49 52 27 53 49 52 27 28 29 30 73 49 67 74 73 49 50 28 28 28 29 30 30 30 30 27 28 53 49 49 49 50 29 75 76 77 57 
78 79 79 79 79 58 58 58 79 79 80 79 79 58 58 79 79 79 81 82 83 83 83 79 78 78 78 78 79 79 79 79 79 78 78 78 78 84 68 69 70 68 68 68 68 68 68 85 86 87 71 49 49 49 49 49 49 67 68 68 68 68 68 68 68 68 85 88 89 49 49 67 74 73 49 67 74 73 49 50 28 90 68 85 91 92 89 49 49 49 49 52 30 27 28 29 73 49 67 85 86 86 93 50 94 95 96 97 
98 99 99 99 100 79 79 79 58 79 79 58 101 79 79 102 99 100 79 103 104 105 105 102 106 78 78 98 99 99 99 99 99 106 78 78 107 108 109 110 68 68 68 68 68 68 68 111 112 113 110 68 68 68 68 68 68 68 68 68 89 49 67 89 49 67 111 114 68 68 68 115 116 92 68 115 116 92 89 49 49 67 68 111 117 92 68 68 68 68 68 72 29 73 49 52 92 69 70 111 112 118 70 89 119 120 121 57 
122 122 122 122 123 124 125 126 127 128 128 129 130 124 124 131 122 123 132 133 133 134 124 131 122 122 122 122 122 122 122 122 122 122 122 122 122 122 135 136 137 138 138 139 140 141 141 142 138 143 144 138 138 139 140 145 146 146 146 146 147 148 148 148 148 148 148 148 148 148 148 148 149 150 148 148 149 151 147 148 148 148 152 147 149 153 148 148 148 152 146 146 154 153 148 149 153 148 152 146 146 146 146 146 146 155 156 157 
