108 8
182
0 0 0 0 0 0 0 0 0 0 0 0 0 0 0 0 0 0 0 0 0 0 0 0 0 0 0 0 0 0 0 0 0 0 0 0 0 0 0 0 0 0 0 0 0 0 0 0 0 0 0 0 0 0 0 0 0 0 0 0 0 0 0 0 0 0 0 0 0 0 0 0 0 0 0 0 0 0 0 0 0 0 0 0 0 0 0 0 0 0 0 0 0 0 0 0 0 0 0 0 0 0 0 0 0 0 0 0 
1 2 1 3 4 5 4 6 1 2 3 4 5 7 5 4 5 4 5 4 6 0 1 0 1 2 0 8 2 2 0 1 0 0 0 9 10 0 9 11 12 13 9 14 15 15 15 15 15 15 15 15 15 15 15 15 15 15 15 15 15 15 15 15 15 15 15 15 15 15 15 15 15 15 15 15 15 15 15 15 15 16 15 15 15 15 15 15 15 15 15 15 15 15 15 15 15 15 15 15 15 15 15 17 0 0 0 0 
18 19 19 20 21 22 21 23 19 19 20 21 22 21 22 21 22 21 22 21 23 1 18 0 19 19 1 18 24 24 0 19 2 2 0 25 26 0 26 27 28 29 25 30 30 30 30 30 30 30 30 30 30 30 30 30 30 30 30 30 30 30 30 30 31 30 30 30 30 30 30 30 30 30 30 30 30 30 30 30 30 30 30 30 30 32 33 33 33 33 33 33 33 33 33 33 33 33 33 33 33 33 33 34 35 36 37 38 
19 39 40 41 42 43 42 42 40 40 40 41 44 40 45 41 46 42 45 40 42 47 47 41 0 2 19 19 48 47 40 40 49 19 0 26 0 50 51 52 53 51 54 55 56 56 56 56 56 56 56 56 56 56 56 56 56 56 56 57 58 58 58 58 59 56 56 56 56 57 58 58 58 58 58 58 58 58 58 58 58 58 60 56 57 58 30 30 30 30 30 30 30 30 30 30 30 30 30 30 30 30 30 30 61 62 63 64 
0 65 66 67 68 67 68 68 66 66 66 67 68 66 66 67 69 68 66 66 68 66 66 67 70 71 72 73 68 66 66 66 74 70 72 72 73 75 76 77 78 79 80 81 82 83 84 84 84 84 84 85 86 84 84 84 84 85 87 88 56 56 56 56 89 83 84 84 84 90 60 56 57 58 60 56 57 58 58 58 58 60 81 83 90 60 56 57 58 58 58 58 58 58 58 58 58 58 60 56 56 56 57 58 91 92 93 64 
94 95 95 95 95 96 96 96 95 95 97 95 95 96 96 95 95 95 98 99 100 100 100 95 101 102 102 103 95 95 95 95 95 101 102 102 103 104 84 85 86 84 84 84 84 84 84 105 106 107 87 108 109 82 82 82 82 110 111 84 84 84 84 84 84 84 105 112 113 88 81 83 90 60 81 83 90 60 56 57 58 114 84 105 115 114 113 88 56 56 56 57 58 58 58 58 60 56 116 105 106 106 117 57 118 119 120 121 
122 123 123 123 124 95 95 95 96 95 125 96 126 95 95 127 123 124 95 128 129 130 130 127 131 132 132 122 123 123 123 123 123 131 132 132 133 134 135 136 111 84 84 84 84 84 84 137 138 139 140 84 84 84 84 84 84 84 84 84 113 82 83 113 82 83 137 141 84 84 84 142 143 114 84 142 143 114 113 88 56 116 84 137 144 114 84 84 84 84 84 90 58 60 56 57 114 85 86 137 138 145 146 147 148 149 150 64 
132 132 132 132 151 152 153 154 155 156 156 157 158 152 152 159 132 151 160 161 161 162 152 159 132 132 132 132 132 132 132 132 132 132 132 132 132 132 163 164 165 166 166 167 168 169 169 170 166 171 172 166 166 167 168 173 82 82 82 82 83 84 84 84 84 84 84 84 84 84 84 174 175 176 84 174 175 177 83 84 84 84 113 83 90 114 84 84 84 113 82 88 57 114 84 90 114 174 178 82 82 108 109 82 179 180 181 64 
